Player_Data,year_start,year_end,height,weight,birth_date,year_active,age_start,age_end,churn
Chet Aubuchon,1947,1947,5-10,137,1916,1,31,31,1
Pete Lalich,1947,1947,6-2,190,1920,1,27,27,1
Harold Kottman,1947,1947,6-8,220,1922,1,25,25,1
Lee Knorek,1947,1950,6-7,215,1921,4,26,29,0
Tom King,1947,1947,6-0,165,1924,1,23,23,1
Jerry Kelly,1947,1948,6-2,172,1918,2,29,30,1
Ken Keller,1947,1947,6-1,180,1922,1,25,25,1
Wilbert Kautz,1947,1947,6-0,180,1915,1,32,32,1
Ed Kasid,1947,1947,5-11,185,1923,1,24,24,1
Tony Kappen,1947,1947,5-10,165,1919,1,28,28,1
Ralph Kaplowitz,1947,1948,6-2,170,1919,2,28,29,1
Hank Lefkowitz,1947,1947,6-2,190,1923,1,24,24,1
Roger Jorgensen,1947,1947,6-5,200,1920,1,27,27,1
Norm Baker,1947,1947,6-0,180,1923,1,24,24,1
Harold Johnson,1947,1947,6-6,240,1920,1,27,27,1
Tony Jaros,1947,1951,6-3,185,1920,5,27,31,0
John Janisch,1947,1948,6-3,200,1920,2,27,28,1
Fred Jacobs,1947,1947,6-3,175,1922,1,25,25,1
Herschel Baltimore,1947,1947,6-4,195,1921,1,26,26,1
Roy Hurley,1947,1947,6-2,170,1922,1,25,25,1
Charlie Hoefer,1947,1948,5-9,158,1921,2,26,27,1
Mel Hirsch,1947,1947,5-6,165,1921,1,26,26,1
Art Hillhouse,1947,1948,6-7,220,1916,2,31,32,1
Noble Jorgensen,1947,1953,6-9,228,1925,7,22,28,0
Sonny Hertzberg,1947,1951,5-10,175,1922,5,25,29,0
Grady Lewis,1947,1949,6-7,215,1917,3,30,32,0
Al Lujack,1947,1947,6-3,220,1920,1,27,27,1
John Murphy,1947,1947,6-2,175,1924,1,23,23,1
Dick Murphy,1947,1947,6-1,175,1921,1,26,26,1
George Munroe,1947,1948,5-11,170,1922,2,25,26,1
Bob Mullens,1947,1947,6-1,175,1922,1,25,25,1
Elmore Morgenthaler,1947,1949,6-9,230,1922,3,25,27,0
Leo Mogus,1947,1951,6-4,190,1921,5,26,30,0
John Mills,1947,1947,6-8,203,1919,1,28,28,1
Walt Miller,1947,1947,6-2,190,1915,1,32,32,1
Harry Miller,1947,1947,6-4,230,1923,1,24,24,1
Nat Militzok,1947,1947,6-3,195,1923,1,24,24,1
John Logan,1947,1951,6-2,175,1921,5,26,30,0
Red Mihalik,1947,1947,6-0,180,1916,1,31,31,1
Ed Melvin,1947,1947,5-9,170,1916,1,31,31,1
George Mearns,1947,1948,6-3,175,1922,2,25,26,1
Bones McKinney,1947,1952,6-6,185,1919,6,28,33,0
Mike McCarron,1947,1950,5-11,180,1922,4,25,28,0
Ariel Maughan,1947,1951,6-4,190,1923,5,24,28,0
Don Martin,1947,1949,6-7,210,1920,3,27,29,0
Dino Martin,1947,1948,5-8,160,1920,2,27,28,1
Press Maravich,1947,1947,6-0,185,1920,1,27,27,1
Frank Mangiapane,1947,1947,5-10,195,1925,1,22,22,1
John Mahnken,1947,1953,6-8,220,1922,7,25,31,0
Stan Miasek,1947,1953,6-5,210,1923,7,24,30,0
Kleggie Hermsen,1947,1953,6-9,225,1923,7,24,30,0
Cecil Hankins,1947,1948,6-1,175,1922,2,25,26,1
Chick Halbert,1947,1951,6-9,225,1919,5,28,32,0
Bob Doll,1947,1950,6-5,195,1919,4,28,31,0
Bob Dille,1947,1947,6-3,190,1917,1,30,30,1
Red Dehnert,1947,1947,6-3,175,1924,1,23,23,1
Bill Davis,1947,1947,6-3,215,1920,1,27,27,1
Aubrey Davis,1947,1947,6-2,175,1921,1,26,26,1
Howie Dallmar,1947,1949,6-4,200,1922,3,25,27,0
Armand Cure,1947,1947,6-0,198,1919,1,28,28,1
Hal Crisler,1947,1947,6-3,215,1923,1,24,24,1
Chuck Connors,1947,1948,6-5,190,1921,2,26,27,1
Bob Cluggish,1947,1947,6-10,235,1917,1,30,30,1
Bob Duffy,1947,1947,6-4,175,1922,1,25,25,1
Don Carlson,1947,1951,6-0,170,1919,5,28,32,0
Ernie Calverley,1947,1949,5-10,145,1924,3,23,25,0
Moe Becker,1947,1947,6-1,185,1917,1,30,30,1
Tom Callahan,1947,1947,6-1,180,1921,1,26,26,1
Hank Beenders,1947,1949,6-6,185,1916,3,31,33,0
Michael Bytzura,1947,1947,6-1,170,1922,1,25,25,1
Tommy Byrnes,1947,1951,6-3,175,1923,5,24,28,0
Leon Brown,1947,1947,6-3,190,1919,1,28,28,1
Harold Brown,1947,1947,6-0,155,1923,1,24,24,1
Aud Brindley,1947,1947,6-4,175,1923,1,24,24,1
Al Brightman,1947,1947,6-2,195,1923,1,24,24,1
Chet Carlisle,1947,1947,6-5,195,1916,1,31,31,1
Frankie Baumholtz,1947,1947,5-10,170,1918,1,29,29,1
Don Eliason,1947,1947,6-2,210,1918,1,29,29,1
Ned Endress,1947,1947,6-2,200,1918,1,29,29,1
Matt Guokas,1947,1947,6-3,195,1915,1,32,32,1
Coulby Gunther,1947,1949,6-4,190,1923,3,24,26,0
Woody Grimshaw,1947,1947,6-1,185,1919,1,28,28,1
Wyndol Gray,1947,1948,6-1,175,1922,2,25,26,1
Leo Gottlieb,1947,1948,5-11,180,1920,2,27,28,1
John Barr,1947,1947,6-3,205,1918,1,29,29,1
Pop Goodwin,1947,1948,6-2,203,1920,2,27,28,1
Ben Goldfaden,1947,1947,6-1,185,1913,1,34,34,1
Chuck Gilmur,1947,1951,6-4,225,1922,5,25,29,0
Gorham Getchell,1947,1947,6-4,205,1920,1,27,27,1
Jack Garfinkel,1947,1949,6-0,190,1918,3,29,31,0
Bob Gantt,1947,1947,6-4,205,1922,1,25,25,1
Joe Fulks,1947,1954,6-5,190,1921,8,26,33,0
Frank Fucarino,1947,1947,6-2,175,1920,1,27,27,1
Frido Frey,1947,1947,6-2,195,1921,1,26,26,1
Nat Frankel,1947,1947,6-0,195,1913,1,34,34,1
Jerry Fleishman,1947,1953,6-2,190,1922,7,25,31,0
Dick Fitzgerald,1947,1948,6-2,175,1920,2,27,28,1
Bob Fitzgerald,1947,1949,6-5,190,1923,3,24,26,0
Warren Fenley,1947,1947,6-3,190,1922,1,25,25,1
Bob Feerick,1947,1950,6-3,190,1920,4,27,30,0
Bob Faught,1947,1947,6-5,185,1921,1,26,26,1
Joe Fabel,1947,1947,6-1,190,1913,1,34,34,1
Angelo Musi,1947,1949,5-9,145,1918,3,29,31,0
Al Negratti,1947,1947,6-3,200,1921,1,26,26,1
Hank Biasatti,1947,1947,5-11,175,1922,1,25,25,1
Art Spector,1947,1950,6-4,200,1920,4,27,30,0
Jim Seminoff,1947,1950,6-2,190,1922,4,25,28,0
Fred Scolari,1947,1955,5-10,180,1922,9,25,33,0
Stan Stutz,1947,1949,5-10,170,1920,3,27,29,0
Petey Rosenberg,1947,1947,5-10,165,1918,1,29,29,1
Jake Weber,1947,1947,6-6,225,1918,1,29,29,1
Buck Sydnor,1947,1947,5-10,175,1921,1,26,26,1
John Abramovic,1947,1948,6-3,195,1919,2,28,29,1
Don Putman,1947,1950,6-1,170,1922,4,25,28,0
Red Wallace,1947,1947,6-1,185,1918,1,29,29,1
Milt Schoon,1947,1950,6-7,230,1922,4,25,28,0
Virgil Vaughn,1947,1947,6-4,205,1918,1,29,29,1
George Senesky,1947,1954,6-2,179,1922,8,25,32,0
Butch Van Breda Kolff,1947,1950,6-3,185,1922,4,25,28,0
Ossie Schectman,1947,1947,6-0,175,1919,1,28,28,1
Ben Scharnus,1947,1949,6-2,173,1917,3,30,32,0
Mel Riebe,1947,1949,5-11,180,1916,3,31,33,0
Kenny Sailors,1947,1951,5-10,175,1921,5,26,30,0
Irv Torgoff,1947,1949,6-2,192,1917,3,30,32,0
Ed Sadowski,1947,1950,6-5,240,1917,4,30,33,0
Jerry Rullo,1947,1950,5-10,165,1923,4,24,27,0
Gino Sovran,1947,1947,6-2,175,1924,1,23,23,1
Giff Roux,1947,1949,6-5,195,1923,3,24,26,0
Mickey Rottner,1947,1948,5-10,180,1919,2,28,29,1
Irv Rothenberg,1947,1949,6-7,215,1921,3,26,28,0
Bob Rensberger,1947,1947,6-2,170,1921,1,26,26,1
Nick Shaback,1947,1947,5-11,180,1918,1,29,29,1
Dick Schulz,1947,1950,6-2,192,1917,4,30,33,0
George Pearcy,1947,1947,6-1,165,1919,1,28,28,1
Lou Spicer,1947,1947,6-2,195,1922,1,25,25,1
Deb Smith,1947,1947,6-3,180,1920,1,27,27,1
Johnny Norlander,1947,1951,6-3,180,1921,5,26,30,0
George Nostrand,1947,1950,6-8,195,1924,4,23,26,0
Stan Noszka,1947,1949,6-1,185,1920,3,27,29,0
Belus Smawley,1947,1952,6-1,195,1918,6,29,34,0
Johnny Simmons,1947,1947,6-1,184,1924,1,23,23,1
Henry Pearcy,1947,1947,6-1,170,1922,1,25,25,1
Buddy O'Grady,1947,1949,5-11,160,1920,3,27,29,0
Ralph Siewert,1947,1947,7-1,230,1923,1,24,24,1
Garland O'Shields,1947,1947,6-1,195,1921,1,26,26,1
Harry Zeller,1947,1947,6-4,210,1919,1,28,28,1
Connie Simmons,1947,1956,6-8,222,1925,10,22,31,0
Art Stolkey,1947,1947,6-1,180,1920,1,27,27,1
George Pastushok,1947,1947,6-1,195,1922,1,25,25,1
Earl Shannon,1947,1949,5-11,170,1921,3,26,28,0
Marty Passaglia,1947,1949,6-1,170,1919,3,28,30,0
Bob Shea,1947,1947,6-2,194,1924,1,23,23,1
Max Zaslofsky,1947,1956,6-2,170,1925,10,22,31,0
Doyle Parrack,1947,1947,6-0,165,1921,1,26,26,1
Hank Rosenstein,1947,1947,6-4,185,1920,1,27,27,1
Fred Sheffield,1947,1947,6-2,165,1923,1,24,24,1
Bud Palmer,1947,1949,6-4,180,1921,3,26,28,0
Paul Hoffman,1948,1955,6-2,195,1925,8,23,30,0
Paul Seymour,1948,1960,6-1,180,1928,13,20,32,0
Gene Stump,1948,1950,6-2,185,1923,3,25,27,0
Mel Thurston,1948,1948,6-0,175,1919,1,29,29,1
Buddy Jeannette,1948,1950,5-11,175,1917,3,31,33,0
Herm Fuetsch,1948,1948,6-0,170,1918,1,30,30,1
Jack Hewson,1948,1948,6-6,195,1924,1,24,24,1
Johnny Ezersky,1948,1950,6-3,175,1922,3,26,28,0
Bill Downey,1948,1948,6-6,210,1923,1,25,25,1
Nat Hickey,1948,1948,5-11,180,1902,1,46,46,1
Elmer Gainer,1948,1950,6-6,195,1918,3,30,32,0
Ben Schadler,1948,1948,6-0,185,1924,1,24,24,1
Bob Hubbard,1948,1949,6-6,215,1922,2,26,27,1
Sid Tanenbaum,1948,1949,6-0,160,1925,2,23,24,1
Dick Holub,1948,1948,6-6,205,1921,1,27,27,1
Bulbs Ehlers,1948,1949,6-3,198,1923,2,25,26,1
Paul Huston,1948,1948,6-3,175,1925,1,23,23,1
Jack Toomay,1948,1950,6-6,215,1922,3,26,28,0
Carl Braun,1948,1962,6-5,180,1927,15,21,35,0
Saul Mariaschin,1948,1948,5-11,165,1924,1,24,24,1
Stan Brown,1948,1952,6-3,200,1929,5,19,23,0
Carl Meinhold,1948,1949,6-2,185,1926,2,22,23,1
Johnny Jorgensen,1948,1949,6-2,185,1921,2,27,28,1
Dick O'Keefe,1948,1951,6-2,185,1923,4,25,28,0
Wat Misaka,1948,1948,5-7,150,1923,1,25,25,1
Gene Vance,1948,1952,6-3,195,1923,5,25,29,0
Chick Reiser,1948,1950,5-11,165,1914,3,34,36,0
Ray Kuka,1948,1949,6-3,200,1922,2,26,27,1
Andy Phillip,1948,1958,6-2,195,1922,11,26,36,0
Bob O'Brien,1948,1949,6-4,190,1927,2,21,22,1
Chet McNabb,1948,1948,6-2,200,1920,1,28,28,1
Red Rocha,1948,1957,6-9,185,1923,10,25,34,0
Paul Noel,1948,1952,6-4,185,1924,5,24,28,0
Jack Tingle,1948,1949,6-4,205,1924,2,24,25,1
Chink Crossin,1948,1950,6-1,165,1923,3,25,27,0
Mike Bloom,1948,1949,6-6,190,1915,2,33,34,1
Lee Robbins,1948,1949,6-3,175,1922,2,26,27,1
Jack Rocker,1948,1948,6-5,185,1922,1,26,26,1
Herm Klotz,1948,1948,5-7,150,1921,1,27,27,1
Gene Rock,1948,1948,5-9,155,1921,1,27,27,1
Arnie Ferrin,1949,1951,6-2,180,1925,3,24,26,0
Jack Eskridge,1949,1949,6-5,200,1924,1,25,25,1
Darrell Brown,1949,1949,6-2,175,1923,1,26,26,1
Jake Bornheimer,1949,1950,6-5,200,1927,2,22,23,1
Price Brookfield,1949,1950,6-4,185,1920,2,29,30,1
Charlie Black,1949,1952,6-5,200,1921,4,28,31,0
Jim Springer,1949,1949,6-9,235,1926,1,23,23,1
Phil Farbman,1949,1949,6-1,185,1924,1,25,25,1
Jim Spruill,1949,1949,6-2,225,1923,1,26,26,1
Bob Brown,1949,1950,6-4,205,1923,2,26,27,1
Hal Tidrick,1949,1949,6-1,190,1915,1,34,34,1
Walt Budko,1949,1952,6-5,220,1925,4,24,27,0
D.C. Wilcutt,1949,1950,6-2,165,1923,2,26,27,1
Andy Tonkovich,1949,1949,6-1,185,1922,1,27,27,1
Bob Davies,1949,1955,6-1,175,1920,7,29,35,0
Fran Curran,1949,1950,6-0,175,1922,2,27,28,1
Bob Tough,1949,1950,6-0,185,1920,2,29,30,1
Dillard Crocker,1949,1953,6-4,205,1925,5,24,28,0
Blackie Towery,1949,1950,6-4,210,1920,2,29,30,1
Andy Duncan,1949,1951,6-6,195,1922,3,27,29,0
Dick Triptow,1949,1950,6-0,170,1922,2,27,28,1
Jack Dwan,1949,1949,6-4,200,1921,1,28,28,1
Joe Colone,1949,1949,6-5,210,1924,1,25,25,1
Lonnie Eggleston,1949,1949,6-0,170,1918,1,31,31,1
Brady Walker,1949,1952,6-6,205,1921,4,28,31,0
Bill Calhoun,1949,1955,6-3,180,1927,7,22,28,0
Bobby Wanzer,1949,1957,6-0,170,1921,9,28,36,0
Dick Wehr,1949,1949,6-4,180,1925,1,24,24,1
Ray Ellefson,1949,1951,6-8,230,1922,3,27,29,0
Jim Browne,1949,1950,6-10,235,1930,2,19,20,1
Ward Williams,1949,1949,6-4,195,1923,1,26,26,1
Richie Niemiera,1949,1950,6-1,165,1921,2,28,29,1
Otto Schnellbacher,1949,1949,6-4,185,1923,1,26,26,1
Donnie Forman,1949,1949,5-10,175,1926,1,23,23,1
Dan Kraus,1949,1949,6-0,195,1923,1,26,26,1
Andrew Levane,1949,1953,6-2,190,1920,5,29,33,0
Freddie Lewis,1949,1950,6-2,195,1921,2,28,29,1
Ray Ramsey,1949,1949,6-2,165,1921,1,28,28,1
Howie Rader,1949,1949,6-1,190,1921,1,28,28,1
Al Lucas,1949,1949,6-3,195,1922,1,27,27,1
Gale Bishop,1949,1949,6-3,195,1922,1,27,27,1
Ray Lumpp,1949,1953,6-1,178,1923,5,26,30,0
Jack Maddox,1949,1949,6-3,185,1919,1,30,30,1
Roy Pugh,1949,1949,6-6,210,1922,1,27,27,1
Lionel Malamed,1949,1949,5-9,150,1924,1,25,25,1
John Mandic,1949,1950,6-4,205,1919,2,30,31,1
Les Pugh,1949,1950,6-7,190,1922,2,27,28,1
Jim Pollard,1949,1955,6-4,185,1922,7,27,33,0
Jake Pelkington,1949,1949,6-6,220,1916,1,33,33,1
Mel McGaha,1949,1949,6-1,190,1926,1,23,23,1
Easy Parham,1949,1951,6-3,200,1921,3,28,30,0
Ed Mikan,1949,1954,6-8,230,1925,6,24,29,0
George Mikan,1949,1956,6-10,245,1924,8,25,32,0
Fred Paine,1949,1949,6-5,210,1925,1,24,24,1
Bill Miller,1949,1949,6-3,190,1924,1,25,25,1
Dermie O'Connell,1949,1950,6-0,174,1928,2,21,22,1
Mike Novak,1949,1954,6-9,219,1915,6,34,39,0
Fritz Nagy,1949,1949,6-2,185,1924,1,25,25,1
Paul Napolitano,1949,1949,6-2,185,1923,1,26,26,1
Andy Kostecka,1949,1949,6-3,203,1921,1,28,28,1
Arnie Risen,1949,1958,6-9,200,1924,10,25,34,0
Leo Klier,1949,1950,6-2,170,1923,2,26,27,1
Walt Kirk,1949,1952,6-3,173,1924,4,25,28,0
Don Smith,1949,1949,6-2,190,1920,1,29,29,1
Jack Smiley,1949,1950,6-3,190,1922,2,27,28,1
Harry Gallatin,1949,1958,6-6,210,1927,10,22,31,0
Earl Gardner,1949,1949,6-3,195,1923,1,26,26,1
Dick Shrider,1949,1949,6-2,190,1923,1,26,26,1
George Glamack,1949,1949,6-6,225,1918,1,31,31,1
Howie Shannon,1949,1950,6-2,175,1923,2,26,27,1
Joe Graboski,1949,1962,6-7,195,1930,14,19,32,0
Bruce Hale,1949,1951,6-1,170,1918,3,31,33,0
Ralph Hamilton,1949,1949,6-1,188,1921,1,28,28,1
John Hazen,1949,1949,6-2,172,1927,1,22,22,1
Bill Henry,1949,1950,6-9,215,1924,2,25,26,1
Odie Spears,1949,1957,6-5,205,1924,9,25,33,0
Jack Nichols,1949,1958,6-7,222,1926,10,23,32,0
Doug Holcomb,1949,1949,6-4,200,1925,1,24,24,1
Red Holzman,1949,1954,5-10,175,1920,6,29,34,0
Gene James,1949,1951,6-4,180,1925,3,24,26,0
Arnie Johnson,1949,1953,6-5,236,1920,5,29,33,0
Whitey Kachan,1949,1949,6-2,175,1925,1,24,24,1
George Kaftan,1949,1953,6-3,190,1928,5,21,25,0
Kenny Rollins,1949,1953,6-0,168,1923,5,26,30,0
Leo Katkaveck,1949,1950,6-0,185,1923,2,26,27,1
Bill Roberts,1949,1950,6-9,210,1925,2,24,25,1
Tom Kelly,1949,1949,6-0,170,1924,1,25,25,1
Tex Ritter,1949,1951,6-2,185,1924,3,25,27,0
Bob Kinney,1949,1950,6-6,215,1920,2,29,30,1
Herm Schaefer,1949,1950,6-0,175,1918,2,31,32,1
Herb Krautblatt,1949,1949,6-1,190,1926,1,23,23,1
Matt Zunic,1949,1949,6-3,195,1919,1,30,30,1
Curly Armstrong,1949,1951,5-11,170,1918,3,31,33,0
Johnny Bach,1949,1949,6-2,180,1924,1,25,25,1
Jack Kerris,1950,1953,6-6,215,1925,4,25,28,0
Hook Dillon,1950,1950,6-3,180,1924,1,26,26,1
Joe Bradley,1950,1950,6-3,175,1928,1,22,22,1
Wah Wah Jones,1950,1952,6-4,225,1926,3,24,26,0
Bob Brannum,1950,1955,6-5,215,1925,6,25,30,0
Mal McMullen,1950,1951,6-5,210,1927,2,23,24,1
Ernie Vandeweghe,1950,1956,6-3,195,1928,7,22,28,0
Frankie Brian,1950,1956,6-1,180,1923,7,27,33,0
Jim Nolan,1950,1950,6-8,210,1927,1,23,23,1
John Pritchard,1950,1950,6-9,220,1927,1,23,23,1
Floyd Volker,1950,1950,6-4,205,1921,1,29,29,1
Whitey Von Nieda,1950,1950,6-1,170,1922,1,28,28,1
Jimmy Darden,1950,1950,6-1,170,1922,1,28,28,1
Clint Wager,1950,1950,6-6,210,1920,1,30,30,1
Danny Wagner,1950,1950,6-0,170,1922,1,28,28,1
Don Otten,1950,1953,6-10,240,1921,4,29,32,0
Earl Dodd,1950,1950,6-5,175,1924,1,26,26,1
Dick Mehen,1950,1952,6-5,195,1922,3,28,30,0
Joe Dolhon,1950,1951,6-0,175,1927,2,23,24,1
Al Miksis,1950,1950,6-7,210,1928,1,22,22,1
Vern Mikkelsen,1950,1959,6-7,230,1928,10,22,31,0
George Feigenbaum,1950,1953,6-1,185,1929,4,21,24,0
Bob Royer,1950,1950,5-10,155,1927,1,23,23,1
Vince Boryla,1950,1954,6-5,210,1927,5,23,27,0
Bob Evans,1950,1950,6-2,175,1925,1,25,25,1
Gene Englund,1950,1950,6-5,205,1917,1,33,33,1
Duane Klueh,1950,1951,6-3,175,1926,2,24,25,1
Don Boven,1950,1953,6-4,210,1925,4,25,28,0
Dike Eddleman,1950,1953,6-3,189,1922,4,28,31,0
Mike Todorovich,1950,1951,6-5,220,1923,2,27,28,1
Ken Menke,1950,1950,6-0,168,1922,1,28,28,1
Ralph Johnson,1950,1953,5-11,170,1921,4,29,32,0
Harry Boykoff,1950,1951,6-10,225,1922,2,28,29,1
Don Ray,1950,1950,6-5,190,1921,1,29,29,1
Harry Donovan,1950,1950,6-2,180,1926,1,24,24,1
Howie Janotta,1950,1950,6-3,185,1924,1,26,26,1
Ralph Beard,1950,1951,5-10,175,1927,2,23,24,1
Dick McGuire,1950,1960,6-0,180,1926,11,24,34,0
Milo Komenich,1950,1950,6-7,212,1920,1,30,30,1
Matt Mazza,1950,1950,6-3,210,1923,1,27,27,1
Stan Patrick,1950,1950,6-2,185,1922,1,28,28,1
Jake Carter,1950,1950,6-4,195,1924,1,26,26,1
Charlie Parsley,1950,1950,6-2,175,1925,1,25,25,1
Murray Wier,1950,1950,5-9,155,1926,1,24,24,1
Ed Macauley,1950,1959,6-8,185,1928,10,22,31,0
John Oldham,1950,1951,6-3,175,1923,2,27,28,1
Al Cervi,1950,1953,5-11,170,1917,4,33,36,0
Jack Parkinson,1950,1950,6-0,174,1924,1,26,26,1
Slater Martin,1950,1960,5-10,170,1925,11,25,35,0
Johnny Macknowsky,1950,1951,6-0,180,1923,2,27,28,1
Gene Ollrich,1950,1950,5-11,160,1922,1,28,28,1
Johnny Orr,1950,1950,6-3,195,1927,1,23,23,1
Red Owens,1950,1952,6-3,185,1925,3,25,27,0
Mac Otten,1950,1950,6-7,220,1925,1,25,25,1
Jack Burmaster,1950,1950,6-3,190,1926,1,24,24,1
Bob Carpenter,1950,1951,6-5,200,1917,2,33,34,1
John Chaney,1950,1950,6-3,185,1920,1,30,30,1
Johnny Payak,1950,1953,6-4,174,1926,4,24,27,0
Leroy Chollet,1950,1951,6-2,190,1925,2,25,26,1
Paul Walther,1950,1955,6-2,160,1927,6,23,28,0
Leo Kubiak,1950,1950,5-11,160,1927,1,23,23,1
Frank Kudelka,1950,1953,6-2,193,1925,4,25,28,0
Jack Cotton,1950,1950,6-7,200,1924,1,26,26,1
Ray Corley,1950,1953,6-0,180,1928,4,22,25,0
Jack Phelan,1950,1950,6-5,195,1925,1,25,25,1
Walt Lautenbach,1950,1950,6-2,185,1922,1,28,28,1
Bobby Cook,1950,1950,5-10,155,1923,1,27,27,1
Tony Lavelli,1950,1951,6-3,185,1926,2,24,25,1
Ed Peterson,1950,1951,6-9,220,1924,2,26,27,1
Ed Leede,1950,1951,6-3,185,1927,2,23,24,1
Warren Perkins,1950,1951,6-3,190,1922,2,28,29,1
Jack Coleman,1950,1958,6-7,195,1924,9,26,34,0
Paul Cloyd,1950,1950,6-2,180,1920,1,30,30,1
Andy O'Donnell,1950,1950,6-1,180,1925,1,25,25,1
Bill Closs,1950,1952,6-5,195,1922,3,28,30,0
Ron Livingstone,1950,1951,6-10,220,1925,2,25,26,1
Joe Holland,1950,1952,6-4,185,1925,3,25,27,0
Pep Saul,1950,1955,6-2,185,1924,6,26,31,0
George Ratkovicz,1950,1955,6-6,220,1922,6,28,33,0
Marshall Hawkins,1950,1950,6-3,205,1924,1,26,26,1
Paul Gordon,1950,1950,6-3,185,1927,1,23,23,1
Ed Bartels,1950,1951,6-5,195,1925,2,25,26,1
Frank Gates,1950,1950,6-0,160,1920,1,30,30,1
Cliff Barker,1950,1952,6-2,185,1921,3,29,31,0
Nelson Bobb,1950,1953,6-0,170,1924,4,26,29,0
Bob Harris,1950,1954,6-7,195,1927,5,23,27,0
Carl Shaeffer,1950,1951,6-3,185,1924,2,26,27,1
Bob Harrison,1950,1958,6-1,190,1927,9,23,31,0
Normie Glick,1950,1950,6-7,190,1927,1,23,23,1
Rollie Seltz,1950,1950,5-10,165,1924,1,26,26,1
Ed Stanczak,1950,1951,6-1,185,1921,2,29,30,1
Billy Hassett,1950,1951,5-11,180,1921,2,29,30,1
Bill Herman,1950,1950,6-3,170,1924,1,26,26,1
Vern Gardner,1950,1952,6-5,200,1925,3,25,27,0
Glen Selbo,1950,1950,6-3,196,1926,1,24,24,1
Howie Schultz,1950,1953,6-6,200,1922,4,28,31,0
Chips Sobek,1950,1950,6-0,180,1920,1,30,30,1
Wayne See,1950,1950,6-3,190,1923,1,27,27,1
Hoot Gibson,1950,1950,6-5,198,1921,1,29,29,1
Jerry Nagel,1950,1950,6-0,190,1928,1,22,22,1
Dee Gibson,1950,1950,5-11,175,1923,1,27,27,1
Joe Mullaney,1950,1950,6-0,165,1924,1,26,26,1
Leo Barnhorst,1950,1954,6-4,190,1924,5,26,30,0
Bill Gabor,1950,1955,5-11,170,1922,6,28,33,0
Don Grate,1950,1950,6-2,185,1923,1,27,27,1
Dale Hamilton,1950,1950,6-0,180,1919,1,31,31,1
Charley Shipp,1950,1950,6-1,200,1913,1,37,37,1
Alex Hannum,1950,1957,6-7,210,1923,8,27,34,0
Bud Grant,1950,1951,6-3,195,1927,2,23,24,1
Al Guokas,1950,1950,6-5,200,1925,1,25,25,1
Robert Hahn,1950,1950,6-10,240,1925,1,25,25,1
Max Morris,1950,1950,6-2,195,1925,1,25,25,1
Gene Berce,1950,1950,5-11,175,1926,1,24,24,1
Marv Schatzman,1950,1950,6-5,200,1927,1,23,23,1
Fred Schaus,1950,1954,6-5,205,1925,5,25,29,0
John Hargis,1950,1951,6-2,180,1920,2,30,31,1
Dolph Schayes,1950,1964,6-8,220,1928,15,22,36,0
Alex Groza,1950,1951,6-7,218,1926,2,24,25,1
Ed Gayda,1951,1951,6-4,210,1927,1,24,24,1
Norm Mager,1951,1951,6-5,185,1926,1,25,25,1
Ed Beach,1951,1951,6-3,200,1929,1,22,22,1
Alan Sawyer,1951,1951,6-5,195,1928,1,23,23,1
Joe McNamee,1951,1952,6-6,210,1926,2,25,26,1
Chuck Mrazovich,1951,1951,6-5,185,1924,1,27,27,1
Gerry Calabrese,1951,1952,6-1,175,1925,2,26,27,1
Nat Clifton,1951,1958,6-6,220,1922,8,29,36,0
Don Lofgran,1951,1954,6-5,200,1929,4,22,25,0
Bob Cousy,1951,1970,6-1,175,1928,20,23,42,0
Earl Lloyd,1951,1960,6-5,200,1928,10,23,32,0
Kevin O'Shea,1951,1953,6-2,175,1925,3,26,28,0
Chuck Cooper,1951,1956,6-5,210,1926,6,25,30,0
Bill Sharman,1951,1961,6-1,175,1926,11,25,35,0
Cal Christensen,1951,1955,6-5,210,1927,5,24,28,0
Bob Lavoy,1951,1954,6-7,185,1926,4,25,28,0
Tommy O'Keefe,1951,1951,6-2,185,1928,1,23,23,1
Ken Murray,1951,1955,6-2,190,1928,5,23,27,0
Hank DeZonie,1951,1951,6-6,215,1922,1,29,29,1
Art Burris,1951,1952,6-5,220,1924,2,27,28,1
Dick Schnittker,1951,1958,6-5,200,1928,8,23,30,0
Leon Blevins,1951,1951,6-2,160,1926,1,25,25,1
Bob Donham,1951,1954,6-2,190,1926,4,25,28,0
Herb Scherer,1951,1952,6-9,212,1928,2,23,24,1
Larry Foust,1951,1962,6-9,215,1928,12,23,34,0
Ike Borsavage,1951,1951,6-8,220,1924,1,27,27,1
Paul Arizin,1951,1962,6-4,190,1928,12,23,34,0
Joe Hutton,1951,1952,6-1,170,1928,2,23,24,1
Don Rehfeldt,1951,1952,6-7,210,1927,2,24,25,1
Jim Riffey,1951,1951,6-4,200,1923,1,28,28,1
Bill Tosheff,1952,1954,6-1,175,1926,3,26,28,0
Neil Johnston,1952,1959,6-8,210,1929,8,23,30,0
Jerry Fowler,1952,1952,6-8,230,1927,1,25,25,1
Bob Wilson,1952,1952,6-4,185,1926,1,26,26,1
Jim Slaughter,1952,1952,6-11,210,1928,1,24,24,1
Ed Dahler,1952,1952,6-5,190,1926,1,26,26,1
Alfred McGuire,1952,1955,6-2,180,1928,4,24,27,0
Chuck Share,1952,1960,6-11,235,1927,9,25,33,0
George King,1952,1958,6-0,175,1928,7,24,30,0
Dick Dickey,1952,1952,6-1,175,1926,1,26,26,1
Ralph O'Brien,1952,1953,5-9,160,1928,2,24,25,1
Mel Payton,1952,1953,6-4,185,1926,2,26,27,1
John McConathy,1952,1952,6-5,195,1930,1,22,22,1
Mel Hutchins,1952,1958,6-6,200,1928,7,24,30,0
Whitey Skoog,1952,1957,5-11,180,1926,6,26,31,0
Jake Fendley,1952,1953,6-0,180,1929,2,23,24,1
Zeke Sinicola,1952,1954,5-10,165,1929,3,23,25,0
John Rennicke,1952,1952,6-2,185,1929,1,23,23,1
Jack Kiley,1952,1953,6-1,170,1929,2,23,24,1
John Pilch,1952,1952,6-3,185,1925,1,27,27,1
Lew Hitch,1952,1957,6-8,200,1929,6,23,28,0
Nate DeLong,1952,1952,6-6,220,1926,1,26,26,1
Don Barksdale,1952,1955,6-6,200,1923,4,29,32,0
Sam Ranzino,1952,1952,6-1,185,1928,1,24,24,1
Don Savage,1952,1957,6-3,205,1928,6,24,29,0
Ray Ragelis,1952,1952,6-4,205,1928,1,24,24,1
Elmer Behnke,1952,1952,6-7,210,1929,1,23,23,1
Dave Minor,1952,1953,6-2,185,1922,2,30,31,1
Wally Osterkorn,1952,1955,6-5,215,1928,4,24,27,0
Gene Rhodes,1953,1953,6-1,170,1927,1,26,26,1
Don Henriksen,1953,1955,6-7,225,1929,3,24,26,0
Claude Overton,1953,1953,6-2,195,1927,1,26,26,1
Moe Radovich,1953,1953,6-0,160,1929,1,24,24,1
Jim Brasco,1953,1953,6-1,170,1931,1,22,22,1
John O'Boyle,1953,1953,6-2,185,1928,1,25,25,1
Jack McCloskey,1953,1953,6-2,190,1925,1,28,28,1
Bob Lochmueller,1953,1953,6-5,185,1927,1,26,26,1
Gene Conley,1953,1964,6-8,225,1930,12,23,34,0
Sherwin Raiken,1953,1953,6-2,185,1928,1,25,25,1
Jim Mooney,1953,1953,6-5,215,1930,1,23,23,1
Dick Groat,1953,1953,5-11,180,1930,1,23,23,1
Eddie Miller,1953,1954,6-8,225,1931,2,22,23,1
Bob Naber,1953,1953,6-3,185,1929,1,24,24,1
Blaine Denning,1953,1953,6-2,175,1930,1,23,23,1
Dick Bunt,1953,1953,6-0,170,1930,1,23,23,1
Bob Priddy,1953,1953,6-3,190,1930,1,23,23,1
Bucky McConnell,1953,1953,5-10,170,1928,1,25,25,1
Mo Mahoney,1953,1954,6-2,205,1927,2,26,27,1
Pete Darcey,1953,1953,6-7,217,1930,1,23,23,1
Zeke Zawoluk,1953,1955,6-7,215,1930,3,23,25,0
George McLeod,1953,1953,6-5,200,1931,1,22,22,1
Mark Workman,1953,1954,6-9,215,1930,2,23,24,1
Jim Holstein,1953,1956,6-3,180,1930,4,23,26,0
Danny Finn,1953,1955,6-1,185,1928,3,25,27,0
Jack McMahon,1953,1960,6-1,185,1928,8,25,32,0
Monk Meineke,1953,1958,6-7,208,1930,6,23,28,0
Don Hanrahan,1953,1953,6-7,200,1929,1,24,24,1
Jim Baechtold,1953,1957,6-4,205,1927,5,26,30,0
Dick Surhoff,1953,1954,6-4,210,1929,2,24,25,1
Al Masino,1953,1954,5-10,174,1928,2,25,26,1
Ralph Polson,1953,1953,6-7,200,1929,1,24,24,1
Bill Mlkvy,1953,1953,6-4,190,1931,1,22,22,1
Hal Uplinger,1954,1954,6-4,185,1929,1,25,25,1
Bob Houbregs,1954,1958,6-7,210,1932,5,22,26,0
Ed Smith,1954,1954,6-6,180,1929,1,25,25,1
Jim Luisi,1954,1954,6-2,180,1928,1,26,26,1
Clyde Lovellette,1954,1964,6-9,234,1929,11,25,35,0
Ray Felix,1954,1962,6-11,220,1930,9,24,32,0
Rollen Hans,1954,1955,6-2,210,1931,2,23,24,1
Norm Swanson,1954,1954,6-6,210,1930,1,24,24,1
Jim Neal,1954,1955,6-11,235,1930,2,24,25,1
Bob Peterson,1954,1956,6-5,210,1932,3,22,24,0
Don Sunderlage,1954,1955,6-1,180,1929,2,25,26,1
Don Asmonga,1954,1954,6-2,185,1928,1,26,26,1
Jack George,1954,1961,6-2,190,1928,8,26,33,0
George Yardley,1954,1960,6-5,190,1928,7,26,32,0
Ernie Barrett,1954,1956,6-3,180,1929,3,25,27,0
Connie Rea,1954,1954,6-3,175,1935,1,19,19,1
Billy Kenville,1954,1960,6-2,187,1930,7,24,30,0
Joe Smyth,1954,1954,6-3,215,1929,1,25,25,1
Don Ackerman,1954,1954,6-0,183,1930,1,24,24,1
Dick Knostman,1954,1954,6-6,215,1931,1,23,23,1
Walt Davis,1954,1958,6-8,205,1931,5,23,27,0
Isaac Walthour,1954,1954,5-11,163,1930,1,24,24,1
Bato Govedarica,1954,1954,5-11,185,1928,1,26,26,1
Jack Molinas,1954,1954,6-6,200,1931,1,23,23,1
James Phelan,1954,1954,6-1,175,1929,1,25,25,1
Gene Dyker,1954,1954,6-6,225,1930,1,24,24,1
Ed Earle,1954,1954,6-3,190,1927,1,27,27,1
Al Roges,1954,1955,6-4,195,1930,2,24,25,1
Irv Bemoras,1954,1957,6-3,185,1930,4,24,27,0
Ernie Beck,1954,1961,6-4,190,1931,8,23,30,0
Jim Fritsche,1954,1955,6-8,210,1931,2,23,24,1
Bill Bolger,1954,1954,6-5,205,1931,1,23,23,1
Norm Grekin,1954,1954,6-5,180,1930,1,24,24,1
Togo Palazzi,1955,1960,6-4,205,1932,6,23,28,0
Chuck Grigsby,1955,1955,6-5,190,1928,1,27,27,1
Bob Carney,1955,1955,6-3,170,1932,1,23,23,1
Ronnie MacGilvray,1955,1955,6-2,185,1930,1,25,25,1
Herm Hedderick,1955,1955,6-5,170,1930,1,25,25,1
Gene Shue,1955,1964,6-2,170,1931,10,24,33,0
Frank Ramsey,1955,1964,6-3,190,1931,10,24,33,0
George Dempsey,1955,1959,6-2,190,1929,5,26,30,0
Ed Kalafat,1955,1957,6-6,245,1932,3,23,25,0
Art Spoelstra,1955,1958,6-9,220,1932,4,23,26,0
Mike Kearns,1955,1955,6-2,178,1929,1,26,26,1
Jack Turner,1955,1955,6-4,170,1930,1,25,25,1
Red Kerr,1955,1966,6-9,230,1932,12,23,34,0
Fred Diute,1955,1955,6-3,210,1929,1,26,26,1
Skippy Whitaker,1955,1955,6-1,180,1930,1,25,25,1
Dan King,1955,1955,6-6,220,1931,1,24,24,1
Bob Knight,1955,1955,6-2,185,1929,1,26,26,1
Frank Selvy,1955,1964,6-3,180,1932,10,23,32,0
Larry Costello,1955,1968,6-1,186,1931,14,24,37,0
Bob Pettit,1955,1965,6-9,205,1932,11,23,33,0
Bobby Watson,1955,1955,6-0,160,1930,1,25,25,1
Dick Rosenthal,1955,1957,6-5,205,1930,3,25,27,0
Dick Farley,1955,1959,6-4,190,1932,5,23,27,0
Fred Christ,1955,1955,6-4,210,1930,1,25,25,1
Jim Tucker,1955,1957,6-7,185,1932,3,23,25,0
Bert Cook,1955,1955,6-3,185,1929,1,26,26,1
Red Morrison,1955,1958,6-8,220,1932,4,23,26,0
Carl McNulty,1955,1955,6-3,185,1930,1,25,25,1
Don Anielak,1955,1955,6-7,190,1930,1,25,25,1
Boris Nachamkin,1955,1955,6-6,210,1933,1,22,22,1
Jackie Moore,1955,1957,6-5,180,1932,3,23,25,0
Tom Brennan,1955,1955,6-3,195,1930,1,25,25,1
Phil Martin,1955,1955,6-3,190,1928,1,27,27,1
Tom Marshall,1955,1959,6-4,215,1931,5,24,28,0
Dick Ricketts,1956,1958,6-7,215,1933,3,23,25,0
Dick Atha,1956,1958,6-2,190,1931,3,25,27,0
Ron Feiereisel,1956,1956,6-3,185,1931,1,25,25,1
Med Park,1956,1960,6-2,205,1933,5,23,27,0
Al Ferrari,1956,1963,6-4,190,1933,8,23,30,0
Johnny Horan,1956,1956,6-8,190,1932,1,24,24,1
Ed Fleming,1956,1960,6-3,189,1933,5,23,27,0
Bob Santini,1956,1956,6-5,190,1935,1,21,21,1
Chuck Mencel,1956,1957,6-0,168,1933,2,23,24,1
Maurice Stokes,1956,1958,6-7,232,1933,3,23,25,0
Chris Harris,1956,1956,6-3,190,1933,1,23,23,1
Jack Stephens,1956,1956,6-3,185,1933,1,23,23,1
Dick Garmaker,1956,1961,6-3,200,1932,6,24,29,0
Larry Hennessy,1956,1957,6-3,185,1929,2,27,28,1
Dick Hemric,1956,1957,6-6,220,1933,2,23,24,1
Tom Gola,1956,1966,6-6,205,1933,11,23,33,0
Kenny Sears,1956,1964,6-9,198,1933,9,23,31,0
Ed Conlin,1956,1962,6-5,200,1933,7,23,29,0
Walter Dukes,1956,1963,7-0,220,1930,8,26,33,0
Jim Loscutoff,1956,1964,6-5,220,1930,9,26,34,0
Red Davis,1956,1956,6-7,220,1932,1,24,24,1
Bob Williams,1956,1957,6-6,230,1931,2,25,26,1
Chuck Noble,1956,1962,6-4,190,1931,7,25,31,0
Richie Regan,1956,1958,6-2,180,1930,3,26,28,0
Corky Devlin,1956,1958,6-5,195,1931,3,25,27,0
Jack Twyman,1956,1966,6-6,210,1934,11,22,32,0
Jesse Arnelle,1956,1956,6-5,220,1933,1,23,23,1
Bob Hopkins,1957,1960,6-8,205,1934,4,23,26,1
Bill Russell,1957,1969,6-10,215,1934,13,23,35,0
Joe Holup,1957,1959,6-6,215,1934,3,23,25,1
Hal Lear,1957,1957,6-0,163,1935,1,22,22,1
John Barber,1957,1957,6-6,210,1927,1,30,30,1
Al Bianchi,1957,1966,6-3,185,1932,10,25,34,0
Phil Jordon,1957,1963,6-10,205,1933,7,24,30,0
Willie Naulls,1957,1966,6-6,225,1934,10,23,32,0
Slick Leonard,1957,1963,6-3,185,1932,7,25,31,0
Norm Stewart,1957,1957,6-5,205,1935,1,22,22,1
Ron Shavlik,1957,1958,6-8,200,1933,2,24,25,1
Richie Guerin,1957,1970,6-4,195,1932,14,25,38,0
Tom Heinsohn,1957,1965,6-7,218,1934,9,23,31,0
Johnny McCarthy,1957,1964,6-1,185,1934,8,23,30,0
Bob Burrow,1957,1958,6-7,228,1934,2,23,24,1
Jim Paxson,1957,1958,6-6,200,1932,2,25,26,1
Ron Sobie,1957,1960,6-3,185,1934,4,23,26,1
Bob Armstrong,1957,1957,6-8,220,1933,1,24,24,1
Jim Ray,1957,1960,6-1,180,1934,4,23,26,1
Bill Thieben,1957,1958,6-7,215,1935,2,22,23,1
Cliff Hagan,1957,1970,6-4,210,1931,14,26,39,0
Lou Tsioropoulos,1957,1959,6-5,190,1930,3,27,29,1
Dave Piontek,1957,1963,6-6,230,1934,7,23,29,0
Si Green,1957,1966,6-2,185,1933,10,24,33,0
Forest Able,1957,1957,6-3,180,1932,1,25,25,1
Gary Bergen,1957,1957,6-8,210,1932,1,25,25,1
Jerry Paulson,1958,1958,6-2,185,1935,1,23,23,1
Brendan McCann,1958,1960,6-2,178,1935,3,23,25,1
Ray Radziszewski,1958,1958,6-5,210,1935,1,23,23,1
Guy Sparrow,1958,1960,6-6,218,1932,3,26,28,1
Pat Dunn,1958,1958,6-2,170,1931,1,27,27,1
Bill Ebben,1958,1958,6-4,190,1935,1,23,23,1
Win Wilfong,1958,1961,6-2,185,1933,4,25,28,1
Jim Walsh,1958,1958,6-4,195,1930,1,28,28,1
Doug Bolstorff,1958,1958,6-4,195,1931,1,27,27,1
Woody Sauldsberry,1958,1966,6-7,220,1934,9,24,32,0
Larry Friend,1958,1958,6-4,185,1935,1,23,23,1
Jim Krebs,1958,1964,6-8,230,1935,7,23,29,0
Hot Rod Hundley,1958,1963,6-4,185,1934,6,24,29,0
George Brown,1958,1958,6-6,190,1935,1,23,23,1
Worthy Patterson,1958,1958,6-2,175,1931,1,27,27,1
Sam Jones,1958,1969,6-4,198,1933,12,25,36,0
McCoy Ingram,1958,1958,6-8,210,1931,1,27,27,1
Lennie Rosenbluth,1958,1959,6-4,190,1933,2,25,26,1
Dick Duckett,1958,1958,6-1,185,1933,1,25,25,1
Charlie Tyra,1958,1962,6-8,230,1935,5,23,27,1
Bo Erias,1958,1958,6-3,220,1932,1,26,26,1
K.C. Jones,1959,1967,6-1,200,1932,9,27,35,0
Hub Reed,1959,1965,6-9,215,1936,7,23,29,0
Mike Farmer,1959,1966,6-7,210,1936,8,23,30,0
Wayne Embry,1959,1969,6-8,240,1937,11,22,32,0
Elgin Baylor,1959,1972,6-5,225,1934,14,25,38,0
Guy Rodgers,1959,1970,6-0,185,1935,12,24,35,0
Tommy Kearns,1959,1959,5-11,185,1936,1,23,23,1
Shellie McMillon,1959,1962,6-5,205,1936,4,23,26,1
Archie Dees,1959,1962,6-8,205,1936,4,23,26,1
Phil Rollins,1959,1961,6-2,185,1934,3,25,27,1
Pete Brennan,1959,1959,6-6,205,1936,1,23,23,1
Dave Gambee,1959,1970,6-6,215,1937,12,22,33,0
Larry Staverman,1959,1964,6-7,205,1936,6,23,28,0
Boo Ellis,1959,1960,6-5,185,1936,2,23,24,1
Andy Johnson,1959,1962,6-5,215,1932,4,27,30,1
Bucky Bockhorn,1959,1965,6-4,200,1933,7,26,32,0
Connie Dierking,1959,1971,6-9,222,1936,13,23,35,0
Bennie Swain,1959,1959,6-8,220,1933,1,26,26,1
Jack Parr,1959,1959,6-9,220,1936,1,23,23,1
Jim Palmer,1959,1961,6-8,224,1933,3,26,28,1
Hal Greer,1959,1973,6-2,175,1936,15,23,37,0
Steve Hamilton,1959,1960,6-6,190,1935,2,24,25,1
Jerry Bird,1959,1959,6-6,210,1935,1,24,24,1
Barney Cable,1959,1964,6-7,175,1935,6,24,29,0
Vern Hatton,1959,1962,6-3,195,1936,4,23,26,1
Wayne Stevens,1960,1960,6-3,185,1936,1,24,24,1
Maury King,1960,1963,6-2,195,1935,4,25,28,1
Nick Mantis,1960,1963,6-3,190,1935,4,25,28,1
Bob Anderegg,1960,1960,6-3,200,1937,1,23,23,1
Joe Ruklick,1960,1962,6-9,220,1938,3,22,24,1
Whitey Bell,1960,1961,6-0,180,1932,2,28,29,1
Dick Barnett,1960,1974,6-4,190,1936,15,24,38,0
Bailey Howell,1960,1971,6-7,210,1937,12,23,34,0
Gary Alcorn,1960,1961,6-9,225,1936,2,24,25,1
Cal Ramsey,1960,1961,6-4,200,1937,2,23,24,1
Rudy LaRusso,1960,1969,6-7,220,1937,10,23,32,0
Johnny Green,1960,1973,6-5,200,1933,14,27,40,0
Bobby Smith,1960,1962,6-4,190,1937,3,23,25,1
Tony Windis,1960,1960,6-1,160,1933,1,27,27,1
Bob Ferry,1960,1969,6-8,230,1937,10,23,32,0
Gene Guarilia,1960,1963,6-5,220,1937,4,23,26,1
John Richter,1960,1960,6-9,225,1937,1,23,23,1
Wilt Chamberlain,1960,1973,7-1,275,1936,14,24,37,0
Tom Hawkins,1960,1969,6-5,210,1936,10,24,33,0
Swede Halbrook,1961,1962,7-3,235,1933,2,28,29,1
Howie Jolliff,1961,1963,6-7,218,1938,3,23,25,1
Darrall Imhoff,1961,1972,6-10,220,1938,12,23,34,0
Jerry West,1961,1974,6-2,175,1938,14,23,36,0
Oscar Robertson,1961,1974,6-5,205,1938,14,23,36,0
Al Attles,1961,1971,6-0,175,1936,11,25,35,0
Don Ohl,1961,1970,6-3,190,1936,10,25,34,0
Ron Johnson,1961,1961,6-8,215,1938,1,23,23,1
Dave Budd,1961,1965,6-6,205,1938,5,23,27,1
Willie Jones,1961,1965,6-3,185,1936,5,25,29,1
Bob McNeill,1961,1962,6-1,170,1938,2,23,24,1
Tom Sanders,1961,1973,6-6,210,1938,13,23,35,0
Bob Boozer,1961,1971,6-8,215,1937,11,24,34,0
Ralph Davis,1961,1962,6-4,180,1938,2,23,24,1
Fred LaCour,1961,1963,6-5,210,1938,3,23,25,1
Jackie Moreland,1961,1970,6-7,215,1938,10,23,32,0
Joe Roberts,1961,1968,6-6,214,1936,8,25,32,0
Lenny Wilkens,1961,1975,6-1,180,1937,15,24,38,0
George Lee,1961,1968,6-4,200,1936,8,25,32,0
Pickles Kennedy,1961,1961,5-11,180,1938,1,23,23,1
Cleo Hill,1962,1962,6-1,185,1938,1,24,24,1
Rich Eichhorst,1962,1962,6-3,200,1933,1,29,29,1
Horace Walker,1962,1962,6-3,210,1937,1,25,25,1
Dave Zeller,1962,1962,6-1,175,1939,1,23,23,1
Ron Horn,1962,1968,6-7,220,1938,7,24,30,0
Bill Smith,1962,1962,6-5,190,1939,1,23,23,1
Whitey Martin,1962,1962,6-2,185,1939,1,23,23,1
York Larese,1962,1962,6-4,183,1938,1,24,24,1
Bob Wiesenhahn,1962,1962,6-4,215,1938,1,24,24,1
Bob Sims,1962,1968,6-5,220,1938,7,24,30,0
Gary Phillips,1962,1966,6-3,189,1939,5,23,27,1
Cleveland Buckner,1962,1963,6-9,210,1938,2,24,25,1
Howie Carl,1962,1962,5-9,160,1938,1,24,24,1
Tom Meschery,1962,1971,6-6,215,1938,10,24,33,0
Sam Stith,1962,1962,6-2,185,1937,1,25,25,1
George Bon Salle,1962,1962,6-8,220,1935,1,27,27,1
Paul Neumann,1962,1967,6-1,175,1938,6,24,29,0
Ray Scott,1962,1972,6-9,215,1938,11,24,34,0
George Blaney,1962,1962,6-1,175,1939,1,23,23,1
Stacey Arceneaux,1962,1962,6-4,210,1936,1,26,26,1
Johnny Egan,1962,1972,5-11,180,1939,11,23,33,0
Lee Shaffer,1962,1964,6-7,220,1939,3,23,25,1
Ted Luckenbill,1962,1963,6-6,205,1939,2,23,24,1
Al Butler,1962,1965,6-2,175,1938,4,24,27,1
Donnie Butcher,1962,1966,6-2,200,1936,5,26,30,1
Bevo Nordmann,1962,1965,6-10,225,1939,4,23,26,1
Jack Turner,1962,1962,6-5,200,1939,1,23,23,1
Jimmy Darrow,1962,1962,5-10,170,1937,1,25,25,1
Adrian Smith,1962,1972,6-1,180,1936,11,26,36,0
Doug Kistler,1962,1962,6-9,210,1938,1,24,24,1
Ed Burton,1962,1965,6-6,225,1939,4,23,26,1
Frank Radovich,1962,1962,6-8,235,1938,1,24,24,1
Joe Buckhalter,1962,1963,6-7,210,1937,2,25,26,1
Walt Bellamy,1962,1975,6-11,225,1939,14,23,36,0
Wayne Yates,1962,1962,6-8,235,1937,1,25,25,1
Chuck Osborne,1962,1962,6-6,210,1939,1,23,23,1
Dave DeBusschere,1963,1974,6-6,220,1940,12,23,34,0
Chico Vaughn,1963,1970,6-2,190,1940,8,23,30,0
Dave Gunther,1963,1963,6-7,190,1937,1,26,26,1
Gene Wiley,1963,1968,6-10,210,1937,6,26,31,0
Mel Nowell,1963,1968,6-2,170,1939,6,24,29,0
Zelmo Beaty,1963,1975,6-9,225,1939,13,24,36,0
Terry Dischinger,1963,1973,6-7,189,1940,11,23,33,0
Dan Tieman,1963,1963,6-0,185,1940,1,23,23,1
Bill Bridges,1963,1975,6-6,228,1939,13,24,36,0
Chet Walker,1963,1975,6-6,212,1940,13,23,35,0
Bud Olsen,1963,1970,6-8,220,1940,8,23,30,0
Dan Swartz,1963,1963,6-4,215,1934,1,29,29,1
Leroy Ellis,1963,1976,6-10,210,1940,14,23,36,0
Gene Tormohlen,1963,1970,6-8,230,1937,8,26,33,0
Porter Meriwether,1963,1963,6-2,180,1940,1,23,23,1
Dave Fedor,1963,1963,6-6,190,1940,1,23,23,1
John Barnhill,1963,1972,6-1,180,1938,10,25,34,0
Johnny Cox,1963,1963,6-4,180,1936,1,27,27,1
Kevin Loughery,1963,1973,6-3,190,1940,11,23,33,0
Ben Warley,1963,1970,6-5,200,1936,8,27,34,0
Danny Doyle,1963,1963,6-8,200,1940,1,23,23,1
John Rudometkin,1963,1965,6-6,205,1940,3,23,25,1
Bill McGill,1963,1970,6-9,225,1939,8,24,31,0
Bob Duffy,1963,1965,6-3,185,1940,3,23,25,1
John Havlicek,1963,1978,6-5,203,1940,16,23,38,0
Jeff Slade,1963,1963,6-6,220,1941,1,22,22,1
Hubie White,1963,1971,6-4,205,1940,9,23,31,0
Charlie Hardnett,1963,1965,6-8,225,1938,3,25,27,1
Ralph Wells,1963,1963,6-1,180,1940,1,23,23,1
Howie Montgomery,1963,1963,6-5,220,1940,1,23,23,1
Wayne Hightower,1963,1972,6-8,192,1940,10,23,32,0
Jack Foley,1963,1963,6-3,170,1939,1,24,24,1
Paul Hogue,1963,1964,6-9,240,1940,2,23,24,1
Don Nelson,1963,1976,6-6,210,1940,14,23,36,0
Tom Stith,1963,1963,6-5,210,1939,1,24,24,1
Len Chappell,1963,1972,6-8,240,1941,10,22,31,0
Don Kojis,1964,1975,6-5,215,1939,12,25,36,0
Eddie Miles,1964,1972,6-4,195,1940,9,24,32,0
Jay Arnette,1964,1966,6-2,175,1938,3,26,28,1
Roger Strickland,1964,1964,6-5,200,1940,1,24,24,1
Tom Thacker,1964,1971,6-2,170,1939,8,25,32,0
Gary Hill,1964,1965,6-4,185,1941,2,23,24,1
Mel Gibson,1964,1964,6-3,180,1940,1,24,24,1
John Windsor,1964,1964,6-8,215,1940,1,24,24,1
Gerry Ward,1964,1967,6-4,195,1941,4,23,26,1
Art Heyman,1964,1970,6-5,205,1941,7,23,29,0
Rod Thorn,1964,1971,6-4,195,1941,8,23,30,0
Nate Thurmond,1964,1977,6-11,225,1941,14,23,36,0
Ken Rohloff,1964,1964,6-0,195,1939,1,25,25,1
Jerry Harkness,1964,1969,6-2,175,1940,6,24,29,0
Larry Siegfried,1964,1972,6-3,190,1939,9,25,33,0
Jerry Lucas,1964,1974,6-8,230,1940,11,24,34,0
Mel Peterson,1964,1970,6-4,185,1938,7,26,32,0
Larry Comley,1964,1964,6-5,210,1939,1,25,25,1
Reggie Harding,1964,1968,7-0,249,1942,5,22,26,1
Tom Hoover,1964,1969,6-9,230,1941,6,23,28,0
Jerry Greenspan,1964,1965,6-5,195,1941,2,23,24,1
Gus Johnson,1964,1973,6-6,230,1938,10,26,35,0
Jim King,1964,1973,6-2,175,1941,10,23,32,0
Jim Barnes,1965,1971,6-8,210,1941,7,24,30,0
Wali Jones,1965,1976,6-2,180,1942,12,23,34,0
John Thompson,1965,1966,6-10,225,1941,2,24,25,1
Barry Kramer,1965,1970,6-4,200,1942,6,23,28,0
Luke Jackson,1965,1972,6-9,240,1941,8,24,31,0
John Tresvant,1965,1973,6-7,215,1939,9,26,34,0
Larry Jones,1965,1974,6-2,180,1942,10,23,32,0
Willis Reed,1965,1974,6-9,235,1942,10,23,32,0
Em Bryant,1965,1972,6-1,175,1938,8,27,34,0
Jeff Mullins,1965,1976,6-4,190,1942,12,23,34,0
Gary Bradds,1965,1971,6-8,210,1942,7,23,29,0
McCoy McLemore,1965,1972,6-7,230,1942,8,23,30,0
Happy Hairston,1965,1975,6-7,225,1942,11,23,33,0
Cotton Nash,1965,1968,6-5,215,1942,4,23,26,1
Walt Hazzard,1965,1974,6-2,185,1942,10,23,32,0
George Wilson,1965,1971,6-8,225,1942,7,23,29,0
Joe Caldwell,1965,1975,6-5,195,1941,11,24,34,0
Bud Koper,1965,1965,6-6,210,1942,1,23,23,1
Howard Komives,1965,1974,6-1,185,1941,10,24,33,0
Les Hunter,1965,1973,6-7,210,1942,9,23,31,0
Paul Silas,1965,1980,6-7,220,1943,16,22,37,0
Steve Courtin,1965,1965,6-1,188,1942,1,23,23,1
Mel Counts,1965,1976,7-0,230,1941,12,24,35,0
Jerry Grote,1965,1965,6-4,215,1940,1,25,25,1
Ron Bonham,1965,1968,6-5,192,1942,4,23,26,1
Rick Barry,1966,1980,6-7,205,1944,15,22,36,0
Bill Buntin,1966,1966,6-7,250,1942,1,24,24,1
Jerry Sloan,1966,1976,6-5,195,1942,11,24,34,0
Dave Stallworth,1966,1975,6-7,200,1941,10,25,34,0
Dick Van Arsdale,1966,1977,6-5,210,1943,12,23,34,0
Barry Clemens,1966,1976,6-6,210,1943,11,23,33,0
Billy Cunningham,1966,1976,6-6,210,1943,11,23,33,0
Bob Warlick,1966,1970,6-5,200,1941,5,25,29,1
Willie Somerset,1966,1969,5-8,170,1942,4,24,27,1
Gail Goodrich,1966,1979,6-1,170,1943,14,23,36,0
Jesse Branson,1966,1968,6-7,195,1942,3,24,26,1
Ron Watts,1966,1967,6-6,210,1943,2,23,24,1
Jim Washington,1966,1976,6-6,210,1943,11,23,33,0
Bob Weiss,1966,1977,6-2,180,1942,12,24,35,0
John Fairchild,1966,1970,6-8,205,1943,5,23,27,1
Fred Hetzel,1966,1971,6-8,220,1942,6,24,29,0
Thales McReynolds,1966,1966,6-3,185,1943,1,23,23,1
Tom Van Arsdale,1966,1977,6-5,202,1943,12,23,34,0
Keith Erickson,1966,1977,6-5,195,1944,12,22,33,0
Jon McGlocklin,1966,1976,6-5,205,1943,11,23,33,0
Joe Strawder,1966,1968,6-10,235,1940,3,26,28,1
Ron Reed,1966,1967,6-5,205,1942,2,24,25,1
Will Frazier,1966,1969,6-7,210,1942,4,24,27,1
Clyde Lee,1967,1976,6-10,205,1944,10,23,32,0
Dick Snyder,1967,1979,6-5,207,1944,13,23,35,0
Cazzie Russell,1967,1978,6-5,218,1944,12,23,34,0
Dave Deutsch,1967,1967,6-1,170,1945,1,22,22,1
Lou Hudson,1967,1979,6-5,210,1944,13,23,35,0
Walt Wesley,1967,1976,6-11,220,1945,10,22,31,0
Neil Johnson,1967,1973,6-7,220,1943,7,24,30,0
Erwin Mueller,1967,1974,6-8,230,1944,8,23,30,0
Hank Finkel,1967,1975,7-0,240,1942,9,25,33,0
Bob Love,1967,1977,6-8,215,1942,11,25,35,0
John Block,1967,1976,6-9,207,1944,10,23,32,0
Dave Schellhase,1967,1968,6-3,205,1944,2,23,24,1
Nate Bowman,1967,1972,6-10,230,1943,6,24,29,0
Henry Akin,1967,1969,6-10,225,1944,3,23,25,1
Matt Guokas,1967,1976,6-5,175,1944,10,23,32,0
Jerry Chambers,1967,1974,6-5,185,1943,8,24,31,0
Jack Marin,1967,1977,6-7,200,1944,11,23,33,0
Freddie Crawford,1967,1971,6-4,189,1941,5,26,30,0
Jim Barnett,1967,1977,6-4,170,1944,11,23,33,0
Tommy Kron,1967,1970,6-5,200,1943,4,24,27,1
Bill Melchionni,1967,1976,6-1,165,1944,10,23,32,0
Dorie Murrey,1967,1972,6-8,215,1943,6,24,29,0
Wayne Molis,1967,1968,6-8,230,1943,2,24,25,1
Jim Ware,1967,1969,6-7,210,1944,3,23,25,1
Toby Kimball,1967,1975,6-6,220,1942,9,25,33,0
Joe Ellis,1967,1974,6-6,175,1944,8,23,30,0
Freddie Lewis,1967,1977,6-0,175,1943,11,24,34,0
Flynn Robinson,1967,1974,6-1,185,1941,8,26,33,0
Bob Hogsett,1967,1968,6-7,230,1941,2,26,27,1
Dave Bing,1967,1978,6-3,180,1943,12,24,35,0
Johnny Austin,1967,1968,6-0,170,1944,2,23,24,1
Archie Clark,1967,1976,6-2,175,1941,10,26,35,0
Jim Hadnot,1968,1968,6-10,235,1940,1,28,28,1
Lonnie Wright,1968,1972,6-2,205,1945,5,23,27,0
Johnny Jones,1968,1969,6-7,205,1943,2,25,26,1
Connie Hawkins,1968,1976,6-8,210,1942,9,26,34,0
Jimmy Jones,1968,1977,6-4,188,1945,10,23,32,0
Al Tucker,1968,1972,6-8,190,1943,5,25,29,0
Clem Haskins,1968,1976,6-3,195,1943,9,25,33,0
Leland Mitchell,1968,1968,6-4,210,1941,1,27,27,1
Willie Murrell,1968,1970,6-6,225,1941,3,27,29,1
John Morrison,1968,1968,6-2,190,1945,1,23,23,1
John Dickson,1968,1968,6-10,240,1945,1,23,23,1
Stephen Vacendak,1968,1970,6-1,185,1944,3,24,26,1
Craig Dill,1968,1968,6-11,215,1944,1,24,24,1
Bobby Rascoe,1968,1970,6-4,205,1940,3,28,30,1
Steve Jones,1968,1976,6-5,205,1942,9,26,34,0
Lester Selvage,1968,1970,6-1,175,1943,3,25,27,1
Doug Moe,1968,1972,6-5,215,1938,5,30,34,0
Bill Dinwiddie,1968,1972,6-7,220,1943,5,25,29,0
Sam Smith,1968,1971,6-7,230,1944,4,24,27,1
Bill Bradley,1968,1977,6-5,205,1943,10,25,34,0
Paul Scranton,1968,1968,6-5,230,1944,1,24,24,1
Cliff Anderson,1968,1971,6-2,200,1944,4,24,27,1
Nick Jones,1968,1973,6-2,190,1945,6,23,28,0
Herschell Turner,1968,1968,6-2,195,1938,1,30,30,1
Bill Bradley,1968,1968,5-11,165,1941,1,27,27,1
Bill Turner,1968,1973,6-7,220,1944,6,24,29,0
Jimmy Rayl,1968,1969,6-2,175,1941,2,27,28,1
Tommy Woods,1968,1968,6-7,210,1943,1,25,25,1
Sonny Dove,1968,1972,6-7,198,1945,5,23,27,0
Gerald Govan,1968,1976,6-10,220,1942,9,26,34,0
Tom Workman,1968,1971,6-7,218,1944,4,24,27,1
Walt Frazier,1968,1980,6-4,200,1945,13,23,35,0
Ervin Inniger,1968,1969,6-4,190,1945,2,23,24,1
Ronald Franz,1968,1973,6-7,205,1945,6,23,28,0
Grant Simmons,1968,1969,6-3,190,1943,2,25,26,1
Gary Gray,1968,1968,6-1,185,1945,1,23,23,1
Bill Meyer,1968,1968,6-3,195,1943,1,25,25,1
Bob Netolicky,1968,1976,6-9,220,1942,9,26,34,0
Jim Fox,1968,1977,6-10,230,1943,10,25,34,0
Calvin Graham,1968,1968,6-2,195,1944,1,24,24,1
Walter Simon,1968,1974,6-6,200,1939,7,29,35,0
Red Stroud,1968,1968,6-0,160,1941,1,27,27,1
Bob Rule,1968,1975,6-9,220,1944,8,24,31,0
Ira Harge,1968,1973,6-9,225,1941,6,27,32,0
Mal Graham,1968,1969,6-1,185,1945,2,23,24,1
Joe Hamood,1968,1968,6-0,180,1943,1,25,25,1
Dennis Holman,1968,1968,6-3,175,1945,1,23,23,1
George Sutor,1968,1970,6-8,235,1943,3,25,27,1
Rubin Russell,1968,1968,6-2,180,1944,1,24,24,1
Ron Filipek,1968,1968,6-5,205,1944,1,24,24,1
Levern Tart,1968,1971,6-2,195,1942,4,26,29,1
Al Salvadori,1968,1968,6-9,220,1945,1,23,23,1
Wesley Bialosuknia,1968,1968,6-2,185,1945,1,23,23,1
Julian Hammond,1968,1972,6-5,205,1943,5,25,29,0
Dennis Hamilton,1968,1971,6-8,210,1944,4,24,27,1
Al Jackson,1968,1968,6-1,185,1943,1,25,25,1
Donnie Freeman,1968,1976,6-3,185,1944,9,24,32,0
Earl Monroe,1968,1980,6-3,185,1944,13,24,36,0
Craig Spitzer,1968,1968,7-0,225,1945,1,23,23,1
Leroy Wright,1968,1969,6-9,215,1938,2,30,31,1
Jim Reid,1968,1968,6-6,210,1945,1,23,23,1
Bill Garner,1968,1968,6-10,220,1940,1,28,28,1
Stew Johnson,1968,1976,6-8,220,1944,9,24,32,0
Roger Schurig,1968,1968,6-3,185,1942,1,26,26,1
Howard Bayne,1968,1968,6-6,235,1942,1,26,26,1
Chuck Gardner,1968,1968,6-8,205,1944,1,24,24,1
Andrew Anderson,1968,1970,6-2,184,1945,3,23,25,1
Hal Hale,1968,1968,6-1,180,1945,1,23,23,1
Kendall Rhine,1968,1969,6-10,230,1943,2,25,26,1
Orbie Bowling,1968,1968,6-10,215,1939,1,29,29,1
Dewitt Menyard,1968,1968,6-10,210,1944,1,24,24,1
Tommie Bowens,1968,1970,6-8,220,1940,3,28,30,1
Bob Riedy,1968,1968,6-6,215,1945,1,23,23,1
David Gaines,1968,1968,6-1,170,1942,1,26,26,1
Carroll Hooser,1968,1968,6-7,230,1944,1,24,24,1
Jay Miller,1968,1971,6-5,205,1943,4,25,28,1
Pat Riley,1968,1976,6-4,205,1945,9,23,31,0
Red Robbins,1968,1975,6-8,190,1944,8,24,31,0
Jim Jarvis,1968,1969,6-1,175,1943,2,25,26,1
Tony Jackson,1968,1969,6-4,200,1942,2,26,27,1
Skip Thoren,1968,1970,6-10,230,1943,3,25,27,1
Phil Jackson,1968,1980,6-8,220,1945,13,23,35,0
Matthew Aitch,1968,1968,6-7,230,1944,1,24,24,1
Bobby Edmonds,1968,1970,6-6,220,1941,3,27,29,1
Jim Burns,1968,1968,6-3,195,1945,1,23,23,1
Larry Conley,1968,1968,6-3,175,1944,1,24,24,1
Willie Porter,1968,1969,6-7,205,1942,2,26,27,1
Paul Long,1968,1971,6-2,180,1944,4,24,27,1
Charles Beasley,1968,1971,6-5,190,1945,4,23,26,1
Elton McGriff,1968,1969,6-9,225,1942,2,26,27,1
Jimmy Walker,1968,1976,6-3,195,1944,9,24,32,0
Larry Bunce,1968,1969,7-0,240,1945,2,23,24,1
Riney Lochmann,1968,1970,6-6,215,1944,3,24,26,1
Randolph Mahaffey,1968,1971,6-7,210,1945,4,23,26,1
John Wetzel,1968,1976,6-5,190,1944,9,24,32,0
Arthur Becker,1968,1973,6-7,205,1942,6,26,31,0
Tom Kerwin,1968,1968,6-7,210,1944,1,24,24,1
John Comeaux,1968,1968,6-5,193,1943,1,25,25,1
Bob Bedell,1968,1971,6-7,205,1944,4,24,27,1
John Postley,1968,1968,6-5,220,1940,1,28,28,1
Jim Davis,1968,1975,6-9,225,1941,8,27,34,0
John Beasley,1968,1974,6-9,225,1944,7,24,30,0
Ronald Kozlicki,1968,1968,6-7,215,1944,1,24,24,1
Bob Verga,1968,1974,6-1,190,1945,7,23,29,0
Steven Kramer,1968,1970,6-5,200,1945,3,23,25,1
Ken Wilburn,1968,1969,6-6,195,1944,2,24,25,1
Johnny Mathis,1968,1968,6-6,220,1943,1,25,25,1
Richard Parks,1968,1968,6-7,235,1943,1,25,25,1
Darel Carrier,1968,1973,6-3,185,1940,6,28,33,0
Trooper Washington,1968,1973,6-7,215,1944,6,24,29,0
Ron Perry,1968,1970,6-3,190,1943,3,25,27,1
Plummer Lott,1968,1969,6-5,210,1945,2,23,24,1
David Lee,1968,1969,6-7,225,1942,2,26,27,1
Mel Daniels,1968,1977,6-9,220,1944,10,24,33,0
Hank Whitney,1968,1970,6-7,230,1939,3,29,31,1
Bob McIntyre,1968,1970,6-6,215,1944,3,24,26,1
Cincinnatus Powell,1968,1975,6-7,220,1942,8,26,33,0
Marlbert Pradd,1968,1969,6-3,170,1944,2,24,25,1
Jim Caldwell,1968,1969,6-10,240,1943,2,25,26,1
George Carter,1968,1976,6-4,210,1944,9,24,32,0
Louie Dampier,1968,1979,6-0,170,1944,12,24,35,0
Maurice McHartley,1968,1970,6-3,185,1942,3,26,28,1
Dave Lattin,1968,1973,6-6,225,1943,6,25,30,0
Stan McKenzie,1968,1974,6-5,195,1944,7,24,30,0
Ron Widby,1968,1968,6-4,210,1945,1,23,23,1
Mike Dabich,1968,1968,7-0,242,1942,1,26,26,1
Tyrone Britt,1968,1968,6-4,190,1944,1,24,24,1
Jeffrey Congdon,1968,1972,6-1,180,1943,5,25,29,0
Al Beard,1968,1968,6-9,200,1942,1,26,26,1
Ollie Darden,1968,1970,6-7,235,1944,3,24,26,1
Roland West,1968,1968,6-4,178,1944,1,24,24,1
Bill Crow,1968,1968,6-1,180,1940,1,28,28,1
Bobby Lloyd,1968,1969,6-2,184,1946,2,22,23,1
Art Williams,1968,1975,6-1,180,1939,8,29,36,0
Rick Weitzman,1968,1968,6-2,175,1946,1,22,22,1
Rich Peek,1968,1968,6-11,230,1943,1,25,25,1
Jerry Pettway,1968,1969,6-3,185,1944,2,24,25,1
Arvesta Kelly,1968,1972,6-2,175,1945,5,23,27,0
Jimmy Dawson,1968,1968,6-0,175,1945,1,23,23,1
Roger Brown,1968,1975,6-5,205,1942,8,26,33,0
Gary Keller,1968,1969,6-9,220,1944,2,24,25,1
George Lehmann,1968,1974,6-0,180,1942,7,26,32,0
Dan Anderson,1968,1969,6-10,230,1943,2,25,26,1
George Peeples,1968,1973,6-7,190,1943,6,25,30,0
Charles Williams,1968,1973,6-0,165,1943,6,25,30,0
Byron Beck,1968,1977,6-9,225,1945,10,23,32,0
Larry Brown,1968,1972,5-9,160,1940,5,28,32,0
Bud Acton,1968,1968,6-6,210,1942,1,26,26,1
Bobby Lewis,1968,1971,6-3,175,1945,4,23,26,1
Leary Lentz,1968,1969,6-6,200,1945,2,23,24,1
Barry Liebowitz,1968,1968,6-2,180,1945,1,23,23,1
Goose Ligon,1968,1974,6-7,210,1944,7,24,30,0
George Patterson,1968,1968,6-8,230,1939,1,29,29,1
Terry Kunze,1968,1968,6-4,210,1943,1,25,25,1
Richard Clark,1968,1969,6-4,190,1944,2,24,25,1
Warren Davis,1968,1973,6-6,212,1943,6,25,30,0
Stephen Chubin,1968,1970,6-2,200,1944,3,24,26,1
Guy Manning,1968,1969,6-6,195,1944,2,24,25,1
Ed Manning,1968,1976,6-7,210,1944,9,24,32,0
Reggie Lacefield,1969,1969,6-5,230,1945,1,24,24,1
George Stone,1969,1972,6-7,195,1946,4,23,26,1
Fred Foster,1969,1977,6-5,210,1946,9,23,31,0
Mervin Jackson,1969,1973,6-3,175,1946,5,23,27,0
Ron Williams,1969,1976,6-3,188,1944,8,25,32,0
Charlie Paulk,1969,1972,6-8,219,1946,4,23,26,1
Tom Boerwinkle,1969,1978,7-0,265,1945,10,24,33,0
Penny Early,1969,1969,5-3,114,1943,1,26,26,1
Willie Rogers,1969,1969,6-3,185,1945,1,24,24,1
Pat Frink,1969,1969,6-4,195,1945,1,24,24,1
Willie Iverson,1969,1969,6-0,180,1945,1,24,24,1
Russell Critchfield,1969,1969,5-10,150,1946,1,23,23,1
Phillip Wagner,1969,1969,6-2,190,1945,1,24,24,1
Walter Piatkowski,1969,1972,6-8,220,1945,4,24,27,1
Elvin Ivory,1969,1969,6-8,210,1948,1,21,21,1
Jack Thompson,1969,1969,6-1,185,1946,1,23,23,1
Stu Lantz,1969,1976,6-3,175,1946,8,23,30,0
Willie Worsley,1969,1969,5-9,175,1945,1,24,24,1
Warren Jabali,1969,1975,6-2,200,1946,7,23,29,0
Ed Johnson,1969,1971,6-8,205,1944,3,25,27,1
Dale Schlueter,1969,1978,6-10,225,1945,10,24,33,0
Don Chaney,1969,1980,6-5,210,1946,12,23,34,0
Tony Koski,1969,1969,6-8,215,1946,1,23,23,1
Tom Kondla,1969,1969,6-8,225,1946,1,23,23,1
Larry Miller,1969,1975,6-4,190,1946,7,23,29,0
Dwight Waller,1969,1972,6-6,220,1945,4,24,27,1
Henry Logan,1969,1970,6-0,180,1946,2,23,24,1
Dick Cunningham,1969,1975,6-10,245,1946,7,23,29,0
Daniel Sparks,1969,1970,6-8,200,1945,2,24,25,1
Bill Hosket,1969,1972,6-8,225,1946,4,23,26,1
Dallas Thornton,1969,1970,6-4,190,1946,2,23,24,1
Rod Knowles,1969,1969,6-9,215,1946,1,23,23,1
Edgar Lacey,1969,1969,6-6,190,1944,1,25,25,1
Sam Williams,1969,1970,6-3,180,1945,2,24,25,1
John Clawson,1969,1969,6-4,200,1944,1,25,25,1
Glynn Saulters,1969,1969,6-2,175,1945,1,24,24,1
Bill Gaines,1969,1969,6-4,185,1946,1,23,23,1
Mike Riordan,1969,1977,6-4,200,1945,9,24,32,0
Bill Hewitt,1969,1975,6-7,210,1944,7,25,31,0
Brian Brunkhorst,1969,1969,6-6,208,1945,1,24,24,1
Mike Lewis,1969,1974,6-8,225,1946,6,23,28,0
Elvin Hayes,1969,1984,6-9,235,1945,16,24,39,0
Bob Warren,1969,1976,6-5,190,1946,8,23,30,0
Wayne Chapman,1969,1972,6-6,190,1945,4,24,27,1
Jim Eakins,1969,1978,6-11,215,1946,10,23,32,0
Otto Moore,1969,1977,6-11,205,1946,9,23,31,0
John Smith,1969,1970,7-0,235,1944,2,25,26,1
Dennis Grey,1969,1970,6-8,215,1947,2,22,23,1
Ron Boone,1969,1981,6-2,200,1946,13,23,35,0
Zaid Abdul-Aziz,1969,1978,6-9,235,1946,10,23,32,0
Gene Moore,1969,1975,6-9,225,1945,7,24,30,0
Harry Barnes,1969,1969,6-3,205,1945,1,24,24,1
John Trapp,1969,1973,6-7,210,1945,5,24,28,0
Greg Smith,1969,1976,6-5,195,1947,8,22,29,0
Bob Quick,1969,1972,6-5,215,1946,4,23,26,1
Al Hairston,1969,1970,6-1,170,1945,2,24,25,1
Glen Combs,1969,1975,6-2,185,1946,7,23,29,0
Don Carlos,1969,1969,6-5,210,1944,1,25,25,1
Craig Raymond,1969,1973,6-11,235,1945,5,24,28,0
Barry Orms,1969,1970,6-3,190,1946,2,23,24,1
Frank Card,1969,1973,6-7,195,1944,5,25,29,0
Dave Newmark,1969,1971,7-0,240,1946,3,23,25,1
Manny Leaks,1969,1974,6-8,225,1945,6,24,29,0
Rick Adelman,1969,1975,6-1,175,1946,7,23,29,0
Bob Allen,1969,1969,6-9,205,1946,1,23,23,1
Jasper Wilson,1969,1970,6-6,200,1947,2,22,23,1
Joe Kennedy,1969,1971,6-6,210,1947,3,22,24,1
Lee Davis,1969,1976,6-8,235,1945,8,24,31,0
Shaler Halimon,1969,1973,6-5,199,1945,5,24,28,0
Donald Sidle,1969,1972,6-8,215,1946,4,23,26,1
Mike Butler,1969,1972,6-2,170,1946,4,23,26,1
Gary Gregor,1969,1974,6-7,225,1945,6,24,29,0
Doug Sims,1969,1969,6-7,195,1943,1,26,26,1
Rich Niemann,1969,1972,7-0,245,1946,4,23,26,1
Jim Kissane,1969,1969,6-7,210,1946,1,23,23,1
Don Dee,1969,1969,6-8,210,1943,1,26,26,1
Art Harris,1969,1972,6-4,185,1947,4,22,25,1
Bob Kauffman,1969,1975,6-8,240,1946,7,23,29,0
Ed Biedenbach,1969,1969,6-1,175,1945,1,24,24,1
Keith Swagerty,1969,1970,6-7,235,1945,2,24,25,1
Rich Johnson,1969,1971,6-7,210,1946,3,23,25,1
Don May,1969,1975,6-4,200,1946,7,23,29,0
Spider Bennett,1969,1969,6-3,190,1943,1,26,26,1
Jay Carty,1969,1969,6-8,220,1941,1,28,28,1
Bobby Hooper,1969,1969,6-0,180,1946,1,23,23,1
Wes Unseld,1969,1981,6-7,245,1946,13,23,35,0
Skip Harlicka,1969,1969,6-1,185,1946,1,23,23,1
Cliff Williams,1969,1969,6-3,180,1945,1,24,24,1
Loy Petersen,1969,1970,6-5,205,1945,2,24,25,1
Butch Joyner,1969,1969,6-5,200,1945,1,24,24,1
Luther Green,1970,1973,6-7,190,1946,4,24,27,1
Norm Van Lier,1970,1979,6-1,173,1947,10,23,32,0
Larry Bergh,1970,1970,6-8,210,1945,1,25,25,1
Jerry Rook,1970,1970,6-5,219,1943,1,27,27,1
Dave Scholz,1970,1970,6-8,220,1948,1,22,22,1
Mike Davis,1970,1973,6-3,185,1946,4,24,27,1
Billy Evans,1970,1970,6-0,170,1947,1,23,23,1
George Thompson,1970,1975,6-2,200,1947,6,23,28,0
Steve Kuberski,1970,1978,6-8,215,1947,9,23,31,0
Justus Thigpen,1970,1974,6-1,160,1947,5,23,27,0
Gene Littles,1970,1975,6-0,160,1943,6,27,32,0
Lee Winfield,1970,1976,6-2,174,1947,7,23,29,0
Lucius Allen,1970,1979,6-2,175,1947,10,23,32,0
Bernie Williams,1970,1974,6-3,175,1945,5,25,29,0
Luther Rackley,1970,1974,6-10,220,1946,5,24,28,0
Skeeter Swift,1970,1974,6-3,204,1946,5,24,28,0
Lamar Green,1970,1975,6-7,210,1947,6,23,28,0
Calvin Fowler,1970,1970,6-0,175,1940,1,30,30,1
Tom Hagan,1970,1971,6-3,185,1947,2,23,24,1
Floyd Theard,1970,1970,6-1,170,1944,1,26,26,1
John Warren,1970,1974,6-3,180,1947,5,23,27,0
Bill Keller,1970,1976,5-10,177,1947,7,23,29,0
Rich Jones,1970,1977,6-6,220,1946,8,24,31,0
Wally Anderzunas,1970,1970,6-7,220,1946,1,24,24,1
Wil Jones,1970,1978,6-8,205,1947,9,23,31,0
John Arthurs,1970,1970,6-4,185,1947,1,23,23,1
Samuel Little,1970,1970,6-0,180,1946,1,24,24,1
Bud Ogden,1970,1971,6-6,215,1946,2,24,25,1
Simmie Hill,1970,1974,6-7,233,1946,5,24,28,0
Bobby Washington,1970,1972,5-11,175,1947,3,23,25,1
Ronald Taylor,1970,1972,7-1,265,1947,3,23,25,1
Bingo Smith,1970,1980,6-5,195,1946,11,24,34,0
Rick Roberson,1970,1976,6-9,231,1947,7,23,29,0
Jerry McKee,1970,1970,6-3,190,1946,1,24,24,1
Bob Portman,1970,1973,6-5,200,1947,4,23,26,1
Hal Jeter,1970,1970,6-3,190,1945,1,25,25,1
Mike Lynn,1970,1971,6-7,215,1945,2,25,26,1
Mike Barrett,1970,1973,6-2,155,1943,4,27,30,1
Bob Dandridge,1970,1982,6-6,195,1947,13,23,35,0
Neal Walk,1970,1977,6-10,220,1948,8,22,29,0
Lonnie Lynn,1970,1970,6-7,215,1943,1,27,27,1
George Tinsley,1970,1972,6-5,205,1946,3,24,26,1
Butch Beard,1970,1979,6-3,185,1947,10,23,32,0
Kareem Abdul-Jabbar,1970,1989,7-2,225,1947,20,23,42,0
Fred Carter,1970,1977,6-3,185,1945,8,25,32,0
Willie Wise,1970,1978,6-5,210,1947,9,23,31,0
Jo Jo White,1970,1981,6-3,190,1946,12,24,35,0
Steve Mix,1970,1983,6-7,215,1947,14,23,36,0
Johnny Baum,1970,1974,6-5,200,1946,5,24,28,0
Bob Woollard,1970,1970,6-10,225,1940,1,30,30,1
John Brisker,1970,1975,6-5,210,1947,6,23,28,0
Spencer Haywood,1970,1983,6-8,225,1949,14,21,34,0
Fatty Taylor,1970,1977,6-0,175,1946,8,24,31,0
Bill Bunting,1970,1972,6-8,200,1947,3,23,25,1
Greg Wittman,1970,1971,6-8,210,1947,2,23,24,1
Bob Christian,1970,1974,6-10,255,1946,5,24,28,0
Grady O'Malley,1970,1970,6-5,205,1948,1,22,22,1
Dick Grubar,1970,1970,6-4,184,1947,1,23,23,1
Dick Garrett,1970,1974,6-3,185,1947,5,23,27,0
Bob Greacen,1970,1972,6-7,206,1947,3,23,25,1
Lynn Shackelford,1970,1970,6-5,190,1947,1,23,23,1
Jack Gillespie,1970,1970,6-6,215,1947,1,23,23,1
Julius Keye,1970,1975,6-10,200,1946,6,24,29,0
Butch Booker,1970,1970,6-10,230,1945,1,25,25,1
Al Cueto,1970,1971,6-7,230,1946,2,24,25,1
Larry Cannon,1970,1974,6-4,195,1947,5,23,27,0
Willie McCarter,1970,1972,6-3,175,1946,3,24,26,1
Brian Heaney,1970,1970,6-2,180,1946,1,24,24,1
Gene Williams,1970,1970,6-7,235,1947,1,23,23,1
George Reynolds,1970,1970,6-4,195,1947,1,23,23,1
Willie Scott,1970,1970,6-5,210,1947,1,23,23,1
Bob Arnzen,1970,1974,6-5,205,1947,5,23,27,0
Mack Calvin,1970,1981,6-0,165,1947,12,23,34,0
Herm Gilliam,1970,1977,6-3,190,1946,8,24,31,0
Jimmy Collins,1971,1972,6-2,175,1946,2,25,26,1
Bill Stricker,1971,1971,6-9,210,1948,1,23,23,1
Levi Fontaine,1971,1971,6-4,190,1948,1,23,23,1
A.W. Holt,1971,1971,6-7,210,1946,1,25,25,1
Jake Ford,1971,1972,6-3,180,1946,2,25,26,1
Curtis Perry,1971,1978,6-7,220,1948,8,23,30,0
Jeff Webb,1971,1972,6-4,170,1948,2,23,24,1
Gary Suiter,1971,1971,6-9,225,1945,1,26,26,1
Samuel Watts,1971,1971,6-3,185,1948,1,23,23,1
Stephen Wilson,1971,1972,6-5,185,1948,2,23,24,1
Gary Freeman,1971,1971,6-9,210,1948,1,23,23,1
Moe Barr,1971,1971,6-4,195,1944,1,27,27,1
Ralph Ogden,1971,1971,6-5,205,1948,1,23,23,1
Eddie Mast,1971,1973,6-9,220,1948,3,23,25,1
Gary Zeller,1971,1972,6-3,205,1947,2,24,25,1
Garfield Smith,1971,1973,6-9,235,1945,3,26,28,1
Mike Silliman,1971,1971,6-6,225,1944,1,27,27,1
Joe Hamilton,1971,1976,5-10,160,1948,6,23,28,0
Calvin Murphy,1971,1983,5-9,165,1948,13,23,35,0
Ralph Simpson,1971,1980,6-5,200,1949,10,22,31,0
Pete Maravich,1971,1980,6-5,197,1947,10,24,33,0
Al Williams,1971,1971,6-6,200,1948,1,23,23,1
Rex Morgan,1971,1972,6-5,190,1948,2,23,24,1
Rick Mount,1971,1975,6-3,175,1947,5,24,28,0
Chuck Williams,1971,1978,6-2,175,1946,8,25,32,0
Harvey Marlatt,1971,1973,6-3,185,1948,3,23,25,1
Bill Zopf,1971,1971,6-1,170,1948,1,23,23,1
Mike Maloy,1971,1973,6-7,215,1949,3,22,24,1
Milt Williams,1971,1975,6-2,182,1945,5,26,30,0
Walt Gilmore,1971,1971,6-6,225,1947,1,24,24,1
Billy Paultz,1971,1985,6-11,235,1948,15,23,37,0
Carl Fuller,1971,1972,6-9,225,1946,2,25,26,1
Fran O'Hanlon,1971,1971,6-1,175,1948,1,23,23,1
Dennis Stewart,1971,1971,6-6,220,1947,1,24,24,1
Earle Higgins,1971,1971,6-8,195,1946,1,25,25,1
Dan Hester,1971,1971,6-8,210,1948,1,23,23,1
Howie Wright,1971,1972,6-3,185,1947,2,24,25,1
Charles Hentz,1971,1971,6-5,210,1947,1,24,24,1
Tom Black,1971,1971,6-10,220,1941,1,30,30,1
Jim Ard,1971,1978,6-8,215,1948,8,23,30,0
Al Henry,1971,1972,6-9,190,1949,2,22,23,1
Charlie Scott,1971,1980,6-5,175,1948,10,23,32,0
Gar Heard,1971,1981,6-6,219,1948,11,23,33,0
Ken Spain,1971,1971,6-9,225,1946,1,25,25,1
Dave Sorenson,1971,1973,6-8,225,1948,3,23,25,1
Jim Hayes,1971,1971,6-3,200,1948,1,23,23,1
Herb White,1971,1971,6-2,195,1948,1,23,23,1
Chuck Lloyd,1971,1971,6-8,220,1947,1,24,24,1
Tiny Archibald,1971,1984,6-1,150,1948,14,23,36,0
Terry Driscoll,1971,1975,6-7,215,1947,5,24,28,0
John Johnson,1971,1982,6-7,200,1947,12,24,35,0
Samuel Robinson,1971,1972,6-7,190,1948,2,23,24,1
Rudy Tomjanovich,1971,1981,6-8,218,1948,11,23,33,0
Earnie Killum,1971,1971,6-3,180,1948,1,23,23,1
Joe Cooke,1971,1971,6-3,175,1948,1,23,23,1
Walker Banks,1971,1971,6-10,205,1947,1,24,24,1
Sam Lacey,1971,1983,6-10,235,1948,13,23,35,0
Fred Taylor,1971,1972,6-5,180,1948,2,23,24,1
Mike Price,1971,1973,6-3,200,1948,3,23,25,1
Ron Knight,1971,1972,6-7,215,1947,2,24,25,1
Larry Mikan,1971,1971,6-7,210,1948,1,23,23,1
Oliver Taylor,1971,1974,6-2,194,1947,4,24,27,1
Bobby Croft,1971,1971,6-10,200,1946,1,25,25,1
Dave Cowens,1971,1983,6-9,230,1948,13,23,35,0
Don Adams,1971,1977,6-6,210,1947,7,24,30,0
Bob Riley,1971,1971,6-9,235,1948,1,23,23,1
Dick Nemelka,1971,1971,6-0,175,1943,1,28,28,1
Greg Howard,1971,1972,6-9,215,1948,2,23,24,1
Ron Nelson,1971,1971,6-2,175,1946,1,25,25,1
Mike Pratt,1971,1972,6-4,195,1948,2,23,24,1
Lonnie Kluttz,1971,1971,6-7,220,1945,1,26,26,1
Cornell Warner,1971,1977,6-9,220,1948,7,23,29,0
John Hummer,1971,1976,6-9,230,1948,6,23,28,0
Greg Hyder,1971,1971,6-6,215,1948,1,23,23,1
Joe Thomas,1971,1971,6-6,205,1948,1,23,23,1
John Vallely,1971,1972,6-3,185,1948,2,23,24,1
Dan Issel,1971,1985,6-9,235,1948,15,23,37,0
Dennis Awtrey,1971,1982,6-10,235,1948,12,23,34,0
Roderick McDonald,1971,1973,6-6,205,1945,3,26,28,1
Joe DePre,1971,1973,6-3,185,1947,3,24,26,1
Billy DeAngelis,1971,1971,6-1,180,1946,1,25,25,1
Jim McMillian,1971,1979,6-5,215,1948,9,23,31,0
Coby Dietrick,1971,1983,6-10,220,1948,13,23,35,0
Claude English,1971,1971,6-4,185,1946,1,25,25,1
Willie Davis,1971,1971,6-8,234,1945,1,26,26,1
Marv Winkler,1971,1972,6-1,164,1948,2,23,24,1
George Irvine,1971,1976,6-6,200,1948,6,23,28,0
Willie Williams,1971,1971,6-7,200,1946,1,25,25,1
George Johnson,1971,1974,6-11,245,1947,4,24,27,1
Vann Williford,1971,1971,6-6,195,1948,1,23,23,1
Geoff Petrie,1971,1976,6-4,190,1948,6,23,28,0
Wendell Ladner,1971,1975,6-5,220,1948,5,23,27,0
Paul Ruffner,1971,1976,6-10,225,1948,6,23,28,0
Greg Fillmore,1971,1972,7-1,240,1947,2,24,25,1
Harry Laurie,1971,1971,6-1,178,1944,1,27,27,1
Pete Cross,1971,1973,6-9,230,1948,3,23,25,1
Bob Lanier,1971,1984,6-11,250,1948,14,23,36,0
Jackie Ridgle,1972,1972,6-4,195,1948,1,24,24,1
Artis Gilmore,1972,1988,7-2,240,1949,17,23,39,0
Marv Roberts,1972,1977,6-8,200,1950,6,22,27,0
Dick Gibbs,1972,1976,6-5,210,1948,5,24,28,0
Rich Rinaldi,1972,1974,6-3,195,1949,3,23,25,1
Howard Porter,1972,1978,6-8,220,1948,7,24,30,0
Barry Yates,1972,1972,6-7,215,1946,1,26,26,1
Gil McGregor,1972,1972,6-8,240,1949,1,23,23,1
Phil Chenier,1972,1981,6-3,180,1950,10,22,31,0
Dave Robisch,1972,1984,6-10,235,1949,13,23,35,0
John Roche,1972,1982,6-3,170,1949,11,23,33,0
Ted McClain,1972,1979,6-1,180,1946,8,26,33,0
Willie Long,1972,1974,6-8,225,1950,3,22,24,1
Steve Patterson,1972,1976,6-9,225,1948,5,24,28,0
Willie Sojourner,1972,1975,6-8,225,1948,4,24,27,1
Sid Catlett,1972,1972,6-6,230,1948,1,24,24,1
Dana Pagett,1972,1972,6-2,180,1949,1,23,23,1
Isaiah Wilson,1972,1973,6-2,175,1948,2,24,25,1
Jake Jones,1972,1972,6-3,180,1949,1,23,23,1
Ron Dorsey,1972,1972,6-4,200,1948,1,24,24,1
Clifford Ray,1972,1981,6-9,230,1949,10,23,32,0
Mike Newlin,1972,1982,6-4,200,1949,11,23,33,0
Mickey Davis,1972,1977,6-7,195,1950,6,22,27,0
Jeff Halliburton,1972,1973,6-5,193,1949,2,23,24,1
Cliff Meely,1972,1976,6-8,215,1947,5,25,29,0
Goo Kennedy,1972,1977,6-5,205,1949,6,23,28,0
Al Smith,1972,1976,6-1,185,1947,5,25,29,0
Jackie Dinkins,1972,1972,6-5,210,1950,1,22,22,1
Tom Owens,1972,1983,6-10,215,1949,12,23,34,0
Randy Denton,1972,1977,6-10,240,1949,6,23,28,0
Mike Grosso,1972,1972,6-9,230,1947,1,25,25,1
Jerry Dover,1972,1972,5-7,155,1949,1,23,23,1
Charlie Yelverton,1972,1972,6-2,190,1948,1,24,24,1
Elmore Smith,1972,1979,7-0,250,1949,8,23,30,0
George Trapp,1972,1977,6-8,205,1948,6,24,29,0
Stan Love,1972,1975,6-9,215,1949,4,23,26,1
John Mengelt,1972,1981,6-2,195,1949,10,23,32,0
Clarence Glover,1972,1972,6-8,210,1947,1,25,25,1
William Smith,1972,1973,7-0,220,1949,2,23,24,1
Charlie Lowery,1972,1972,6-3,185,1949,1,23,23,1
Kenny McIntosh,1972,1975,6-7,225,1949,4,23,26,1
Ken Durrett,1972,1975,6-7,190,1948,4,24,27,1
Jarrett Durham,1972,1972,6-5,188,1949,1,23,23,1
Randy Smith,1972,1983,6-3,180,1948,12,24,35,0
Sidney Wicks,1972,1981,6-8,225,1949,10,23,32,0
Dean Meminger,1972,1977,6-0,175,1948,6,24,29,0
Loyd King,1972,1973,6-2,180,1949,2,23,24,1
Jim Marsh,1972,1972,6-7,215,1946,1,26,26,1
Austin Carr,1972,1981,6-4,200,1948,10,24,33,0
Collis Jones,1972,1975,6-7,203,1949,4,23,26,1
Charlie Davis,1972,1974,6-2,160,1949,3,23,25,1
Julius Erving,1972,1987,6-7,210,1950,16,22,37,0
Jim McDaniels,1972,1978,6-11,228,1948,7,24,30,0
Johnny Neumann,1972,1978,6-6,200,1951,7,21,27,0
Larry Steele,1972,1980,6-5,180,1949,9,23,31,0
Mike Gale,1972,1982,6-4,185,1950,11,22,32,0
Barry Nelson,1972,1972,6-10,230,1949,1,23,23,1
Elnardo Webster,1972,1972,6-5,190,1948,1,24,24,1
Curtis Rowe,1972,1979,6-7,225,1949,8,23,30,0
Dave Wohl,1972,1978,6-2,185,1949,7,23,29,0
Pierre Russell,1972,1973,6-4,190,1949,2,23,24,1
Fred Hilton,1972,1973,6-3,185,1948,2,24,25,1
Jim Cleamons,1972,1980,6-3,185,1949,9,23,31,0
George McGinnis,1972,1982,6-8,235,1950,11,22,32,0
Vic Bartolome,1972,1972,7-0,230,1948,1,24,24,1
Jimmy O'Brien,1972,1975,6-1,170,1950,4,22,25,1
Fred Brown,1972,1984,6-3,182,1948,13,24,36,0
Odis Allison,1972,1972,6-6,195,1949,1,23,23,1
Darnell Hillman,1972,1980,6-9,215,1949,9,23,31,0
Bobby Fields,1972,1972,6-3,175,1949,1,23,23,1
Gene Phillips,1972,1973,6-4,175,1948,2,24,25,1
Mo Layton,1972,1978,6-1,180,1948,7,24,30,0
Nate Williams,1972,1979,6-5,215,1950,8,22,29,0
Tom Payne,1972,1972,7-2,240,1950,1,22,22,1
Ron Sanford,1972,1972,6-9,215,1946,1,26,26,1
Willie Allen,1972,1972,6-6,230,1949,1,23,23,1
Richard Fisher,1972,1972,6-5,215,1948,1,24,24,1
Willie Norwood,1972,1978,6-7,220,1947,7,25,31,0
Walt Szczerbiak,1972,1972,6-6,210,1949,1,23,23,1
Mike Ratliff,1973,1974,6-10,230,1951,2,22,23,1
Jim Price,1973,1979,6-3,195,1949,7,24,30,0
Charles Dudley,1973,1979,6-2,180,1950,7,23,29,0
Freddie Boyd,1973,1978,6-2,180,1950,6,23,28,0
Henry Bibby,1973,1981,6-1,185,1949,9,24,32,0
Paul Stovall,1973,1974,6-4,215,1948,2,25,26,1
Joby Wright,1973,1976,6-8,220,1950,4,23,26,1
William Franklin,1973,1976,6-7,220,1949,4,24,27,1
Stephen Previs,1973,1973,6-3,183,1950,1,23,23,1
George Adams,1973,1975,6-5,210,1949,3,24,26,1
Mike Barr,1973,1977,6-3,180,1950,5,23,27,0
Ollie Johnson,1973,1982,6-6,200,1949,10,24,33,0
Eric McWilliams,1973,1973,6-8,200,1950,1,23,23,1
David Bustion,1973,1973,6-8,215,1949,1,24,24,1
Sam Cash,1973,1973,6-8,230,1950,1,23,23,1
Don Buse,1973,1985,6-4,190,1950,13,23,35,0
Frank Schade,1973,1973,6-1,170,1950,1,23,23,1
Henry Bacon,1973,1973,6-3,205,1948,1,25,25,1
Claude Virden,1973,1973,6-6,195,1947,1,26,26,1
Sam Sibert,1973,1973,6-7,215,1949,1,24,24,1
Harthorne Wingo,1973,1976,6-6,210,1947,4,26,29,1
Steve Bracey,1973,1975,6-1,175,1950,3,23,25,1
Brian Taylor,1973,1982,6-2,185,1951,10,22,31,0
Brian Mahoney,1973,1973,6-3,175,1948,1,25,25,1
LaRue Martin,1973,1976,6-11,208,1950,4,23,26,1
Dwight Davis,1973,1977,6-8,220,1949,5,24,28,0
Chris Ford,1973,1982,6-5,190,1949,10,24,33,0
John Tschogl,1973,1975,6-6,206,1950,3,23,25,1
Bob Ford,1973,1973,6-7,228,1950,1,23,23,1
Lloyd Neal,1973,1979,6-7,225,1950,7,23,29,0
James Silas,1973,1982,6-1,180,1949,10,24,33,0
Ansley Truitt,1973,1973,6-9,215,1950,1,23,23,1
Travis Grant,1973,1976,6-7,215,1950,4,23,26,1
Frank Russell,1973,1973,6-3,180,1949,1,24,24,1
Harold Fox,1973,1973,6-2,175,1949,1,24,24,1
Bill Newton,1973,1974,6-9,220,1950,2,23,24,1
Bob Davis,1973,1973,6-7,215,1950,1,23,23,1
Russ Lee,1973,1975,6-5,185,1950,3,23,25,1
Corky Calhoun,1973,1980,6-7,210,1950,8,23,30,0
Dave Twardzik,1973,1980,6-1,175,1950,8,23,30,0
Bud Stallworth,1973,1977,6-5,190,1950,5,23,27,0
Billy Shepherd,1973,1975,5-10,160,1949,3,24,26,1
George Bruns,1973,1973,6-0,160,1946,1,27,27,1
Paul Westphal,1973,1984,6-4,195,1950,12,23,34,0
John Gianelli,1973,1980,6-10,220,1950,8,23,30,0
Ron Riley,1973,1976,6-8,195,1950,4,23,26,1
George Gervin,1973,1986,6-7,180,1952,14,21,34,0
Charles Johnson,1973,1979,6-0,170,1949,7,24,30,0
Bob Lackey,1973,1974,6-5,200,1949,2,24,25,1
Claude Terry,1973,1978,6-4,195,1950,6,23,28,0
Jim Chones,1973,1982,6-11,220,1949,10,24,33,0
Chuck Terry,1973,1977,6-6,215,1950,5,23,27,0
Roger Brown,1973,1980,6-11,225,1950,8,23,30,0
Scott English,1973,1975,6-6,205,1950,3,23,25,1
Ronald Thomas,1973,1976,6-6,215,1950,4,23,26,1
Mike Jackson,1973,1976,6-7,215,1949,4,24,27,1
Bill Chamberlain,1973,1974,6-6,188,1949,2,24,25,1
Tom Riker,1973,1975,6-10,225,1950,3,23,25,1
Tom Patterson,1973,1974,6-6,220,1948,2,25,26,1
Rowland Garrett,1973,1977,6-6,210,1950,5,23,27,0
Al Sanders,1973,1973,6-7,240,1950,1,23,23,1
Bob Nash,1973,1979,6-8,195,1950,7,23,29,0
George Johnson,1973,1986,6-11,205,1948,14,25,38,0
Kevin Porter,1973,1983,6-0,170,1950,11,23,33,0
Paul McCracken,1973,1977,6-4,180,1950,5,23,27,0
Dennis Wuycik,1973,1975,6-6,215,1950,3,23,25,1
Mark Minor,1973,1973,6-6,215,1950,1,23,23,1
Bob McAdoo,1973,1986,6-9,210,1951,14,22,35,0
Ed Ratleff,1974,1978,6-6,195,1950,5,24,28,0
Bo Lamar,1974,1977,6-1,180,1951,4,23,26,1
Mel Davis,1974,1977,6-6,220,1950,4,24,27,1
Larry Kenon,1974,1983,6-9,205,1952,10,22,31,0
Jim Garvin,1974,1974,6-7,200,1950,1,24,24,1
Slick Watts,1974,1979,6-1,175,1951,6,23,28,0
Wilbert Robinson,1974,1974,6-2,175,1949,1,25,25,1
Nick Weatherspoon,1974,1980,6-7,195,1950,7,24,30,0
Dwight Jones,1974,1983,6-10,210,1952,10,22,31,0
Larry Finch,1974,1975,6-2,185,1951,2,23,24,1
Jim Brewer,1974,1982,6-9,210,1951,9,23,31,0
Tom Ingelsby,1974,1976,6-3,180,1951,3,23,25,1
Kermit Washington,1974,1988,6-8,230,1951,15,23,37,0
Mike Bantom,1974,1982,6-9,200,1951,9,23,31,0
Dennis Bell,1974,1976,6-5,185,1951,3,23,25,1
Kevin Joyce,1974,1976,6-3,190,1951,3,23,25,1
John Williamson,1974,1981,6-2,185,1951,8,23,30,0
Tim Bassett,1974,1980,6-8,225,1951,7,23,29,0
Louie Nelson,1974,1978,6-3,190,1951,5,23,27,0
John Brown,1974,1980,6-7,220,1951,7,23,29,0
Jim Owens,1974,1975,6-5,200,1950,2,24,25,1
Vester Marshall,1974,1974,6-7,200,1948,1,26,26,1
Derrek Dickey,1974,1978,6-7,218,1951,5,23,27,0
Kevin Kunnert,1974,1982,7-0,230,1951,9,23,31,0
Tom Kozelko,1974,1976,6-8,220,1951,3,23,25,1
Ben Kelso,1974,1974,6-3,195,1949,1,25,25,1
Ernie DiGregorio,1974,1978,6-0,180,1951,5,23,27,0
Ron Behagen,1974,1980,6-9,185,1951,7,23,29,0
Jim Bradley,1974,1976,6-8,215,1952,3,22,24,1
Billy James,1974,1974,6-3,185,1950,1,24,24,1
Patrick McFarland,1974,1976,6-5,185,1951,3,23,25,1
Ted Manakas,1974,1974,6-2,180,1951,1,23,23,1
Mike Green,1974,1980,6-10,200,1951,7,23,29,0
Bird Averitt,1974,1978,6-1,170,1952,5,22,26,0
Ronnie Robinson,1974,1975,6-8,200,1951,2,23,24,1
Bruce Seals,1974,1978,6-8,210,1953,5,21,25,0
Mike Macaluso,1974,1974,6-5,210,1951,1,23,23,1
Charles Edge,1974,1975,6-6,210,1950,2,24,25,1
Gary Melchionni,1974,1975,6-2,185,1951,2,23,24,1
Nate Hawthorne,1974,1976,6-4,190,1950,3,24,26,1
Ron King,1974,1974,6-4,185,1951,1,23,23,1
Jim O'Brien,1974,1975,6-7,200,1951,2,23,24,1
Mike D'Antoni,1974,1977,6-3,185,1951,4,23,26,1
Allie McGuire,1974,1974,6-3,175,1951,1,23,23,1
Billy Schaeffer,1974,1976,6-5,200,1951,3,23,25,1
Bernie Fryer,1974,1975,6-3,185,1949,2,25,26,1
E.C. Coleman,1974,1979,6-8,225,1950,6,24,29,0
Jerry Pender,1974,1974,6-2,185,1950,1,24,24,1
Rod Freeman,1974,1974,6-7,225,1950,1,24,24,1
Swen Nater,1974,1984,6-11,240,1950,11,24,34,0
Roy Ebron,1974,1974,6-9,220,1951,1,23,23,1
Mark Sibley,1974,1974,6-2,175,1950,1,24,24,1
Larry McNeill,1974,1979,6-9,195,1951,6,23,28,0
Allan Bristow,1974,1983,6-7,210,1951,10,23,32,0
Caldwell Jones,1974,1990,6-11,217,1950,17,24,40,0
Steve Downing,1974,1975,6-8,225,1950,2,24,25,1
Doug Collins,1974,1981,6-6,180,1951,8,23,30,0
Barry Parkhill,1974,1976,6-4,185,1951,3,23,25,1
Joe Reaves,1974,1974,6-5,210,1950,1,24,24,1
Phil Hankinson,1974,1975,6-8,195,1951,2,23,24,1
Ken Charles,1974,1978,6-3,180,1951,5,23,27,0
Luke Witte,1974,1976,7-0,235,1950,3,24,26,1
Truck Robinson,1975,1985,6-7,225,1951,11,24,34,0
Glenn McDonald,1975,1977,6-6,190,1952,3,23,25,1
Fred Saunders,1975,1978,6-7,210,1951,4,24,27,1
Greg Jackson,1975,1975,6-0,180,1952,1,23,23,1
Gus Bailey,1975,1980,6-5,185,1951,6,24,29,0
Connie Norman,1975,1979,6-3,175,1953,5,22,26,0
Eric Money,1975,1980,6-0,170,1955,6,20,25,0
Aaron James,1975,1979,6-8,210,1952,5,23,27,0
Mickey Johnson,1975,1986,6-10,190,1952,12,23,34,0
Maurice Lucas,1975,1988,6-9,215,1952,14,23,36,0
Kevin Restani,1975,1982,6-9,225,1951,8,24,31,0
Roy McPipe,1975,1975,6-3,205,1950,1,25,25,1
Steve Hawes,1975,1984,6-9,220,1950,10,25,34,0
Al Skinner,1975,1980,6-3,190,1952,6,23,28,0
Billy Harris,1975,1975,6-2,185,1951,1,24,24,1
Aulcie Perry,1975,1975,6-10,210,1950,1,25,25,1
Bill Higgins,1975,1975,6-2,180,1952,1,23,23,1
Wayne Pack,1975,1975,6-0,165,1950,1,25,25,1
Bobby Jones,1975,1986,6-9,210,1951,12,24,35,0
Reggie Royals,1975,1975,6-10,200,1950,1,25,25,1
Moses Malone,1975,1995,6-10,215,1955,21,20,40,0
Marvin Barnes,1975,1980,6-8,210,1952,6,23,28,0
Campy Russell,1975,1985,6-8,215,1952,11,23,33,0
Bill Ligon,1975,1975,6-4,180,1952,1,23,23,1
Len Kosmalski,1975,1976,7-0,245,1951,2,24,25,1
Wardell Jackson,1975,1975,6-7,200,1951,1,24,24,1
Greg Lee,1975,1976,6-3,190,1951,2,24,25,1
Billy Knight,1975,1985,6-6,195,1952,11,23,33,0
Frank Kendrick,1975,1975,6-6,198,1950,1,25,25,1
Bernie Harris,1975,1975,6-10,200,1950,1,25,25,1
Tom Henderson,1975,1983,6-3,190,1952,9,23,31,0
Phil Lumpkin,1975,1976,6-0,165,1951,2,24,25,1
Dan Anderson,1975,1976,6-2,185,1951,2,24,25,1
Tal Skinner,1975,1976,6-5,195,1952,2,23,24,1
Leonard Gray,1975,1977,6-8,240,1951,3,24,26,1
Donald Washington,1975,1976,6-8,210,1952,2,23,24,1
Fly Williams,1975,1975,6-5,200,1953,1,22,22,1
Leon Benbow,1975,1976,6-4,185,1950,2,25,26,1
Dennis DuVal,1975,1976,6-3,175,1952,2,23,24,1
Dean Tolson,1975,1978,6-8,190,1951,4,24,27,1
Al Eberhard,1975,1978,6-6,225,1952,4,23,26,1
Stan Washington,1975,1975,6-4,190,1952,1,23,23,1
Lloyd Batts,1975,1975,6-4,185,1951,1,24,24,1
Ken Boyd,1975,1975,6-5,195,1952,1,23,23,1
Brian Winters,1975,1983,6-4,185,1952,9,23,31,0
Phil Smith,1975,1983,6-4,185,1952,9,23,31,0
Len Elmore,1975,1984,6-9,220,1952,10,23,32,0
Don Smith,1975,1975,6-0,160,1951,1,24,24,1
Darrell Elston,1975,1977,6-4,190,1952,3,23,25,1
Ben Clyde,1975,1975,6-7,198,1951,1,24,24,1
Scott Wedman,1975,1987,6-7,215,1952,13,23,35,0
Owen Wells,1975,1975,6-7,200,1950,1,25,25,1
Collis Temple,1975,1975,6-8,220,1952,1,23,23,1
Jimmy Foster,1975,1976,6-1,175,1951,2,24,25,1
Harvey Catchings,1975,1985,6-9,218,1951,11,24,34,0
Kevin Stacom,1975,1982,6-3,185,1951,8,24,31,0
Gus Gerard,1975,1981,6-8,200,1953,7,22,28,0
Mike Sojourner,1975,1977,6-9,225,1953,3,22,24,1
Jamaal Wilkes,1975,1986,6-6,190,1953,12,22,33,0
Lionel Billingy,1975,1975,6-9,215,1952,1,23,23,1
John Drew,1975,1985,6-6,205,1954,11,21,31,0
Clyde Dickey,1975,1975,6-3,185,1951,1,24,24,1
Hank Williams,1975,1975,6-5,210,1952,1,23,23,1
Jan Van Breda Kolff,1975,1983,6-7,195,1951,9,24,32,0
David Vaughn,1975,1976,6-11,220,1952,2,23,24,1
Earl Williams,1975,1979,6-7,230,1951,5,24,28,0
Bill Walton,1975,1987,6-11,210,1952,13,23,35,0
Jesse Dark,1975,1975,6-5,210,1951,1,24,24,1
Foots Walker,1975,1984,6-0,184,1951,10,24,33,0
Gary Brokaw,1975,1978,6-4,178,1954,4,21,24,1
Rod Derline,1975,1976,6-0,175,1952,2,23,24,1
Bobby Wilson,1975,1978,6-3,175,1951,4,24,27,1
Tom Burleson,1975,1981,7-2,225,1952,7,23,29,0
Perry Warbington,1975,1975,6-2,165,1952,1,23,23,1
Jerry Baskerville,1976,1976,6-7,190,1951,1,25,25,1
Don Ford,1976,1982,6-9,215,1952,7,24,30,0
Wilbur Holland,1976,1979,6-0,175,1951,4,25,28,1
Lionel Hollins,1976,1985,6-3,185,1953,10,23,32,0
Rudy White,1976,1981,6-2,195,1953,6,23,28,0
World B. Free,1976,1988,6-2,185,1953,13,23,35,0
Larry Fogle,1976,1976,6-5,205,1953,1,23,23,1
Ken Mayfield,1976,1976,6-2,185,1948,1,28,28,1
Clyde Mayes,1976,1977,6-8,225,1953,2,23,24,1
Dwaine Dillard,1976,1976,6-6,230,1949,1,27,27,1
Kenneth Gardner,1976,1976,6-5,205,1949,1,27,27,1
Mike Flynn,1976,1978,6-2,180,1953,3,23,25,1
M.L. Carr,1976,1985,6-6,205,1951,10,25,34,0
Al Carlson,1976,1976,6-11,235,1951,1,25,25,1
Ed Searcy,1976,1976,6-6,210,1952,1,24,24,1
Tom Kropp,1976,1977,6-3,205,1953,2,23,24,1
Ricky Sobers,1976,1986,6-3,198,1953,11,23,33,0
Robert Hawkins,1976,1979,6-4,190,1954,4,22,25,1
Mark Olberding,1976,1987,6-8,225,1956,12,20,31,0
Jim McElroy,1976,1982,6-3,190,1953,7,23,29,0
Allen Murphy,1976,1977,6-5,190,1952,2,24,25,1
Cliff Pondexter,1976,1978,6-9,233,1954,3,22,24,1
Bob Bigelow,1976,1979,6-7,215,1953,4,23,26,1
George Bucci,1976,1976,6-3,200,1953,1,23,23,1
Eric Fernsten,1976,1984,6-10,205,1953,9,23,31,0
Jerome Anderson,1976,1977,6-5,195,1953,2,23,24,1
Kim Hughes,1976,1981,6-11,220,1952,6,24,29,0
Tom McMillen,1976,1986,6-11,215,1952,11,24,34,0
Henry Dickerson,1976,1977,6-4,190,1951,2,25,26,1
Alvan Adams,1976,1988,6-9,210,1954,13,22,34,0
Charles Jordan,1976,1976,6-8,220,1954,1,22,22,1
John Laskowski,1976,1977,6-6,185,1953,2,23,24,1
Jimmie Baker,1976,1976,6-9,220,1953,1,23,23,1
Monte Towe,1976,1977,5-7,150,1953,2,23,24,1
John Lambert,1976,1982,6-10,225,1953,7,23,29,0
Jimmy Conner,1976,1976,6-4,190,1953,1,23,23,1
Junior Bridgeman,1976,1987,6-5,210,1953,12,23,34,0
Dennis Van Zant,1976,1976,6-9,210,1952,1,24,24,1
Rich Kelley,1976,1986,7-0,235,1953,11,23,33,0
Darryl Dawkins,1976,1989,6-11,251,1957,14,19,32,0
Bill Robinzine,1976,1982,6-7,230,1953,7,23,29,0
Henry Ward,1976,1977,6-4,195,1952,2,24,25,1
Skip Wise,1976,1976,6-2,170,1955,1,21,21,1
Bill Willoughby,1976,1984,6-8,205,1957,9,19,27,0
Joe Meriweather,1976,1985,6-10,215,1953,10,23,32,0
Harry Rogers,1976,1976,6-7,195,1950,1,26,26,1
Tom Boswell,1976,1984,6-9,220,1953,9,23,31,0
David Thompson,1976,1984,6-4,195,1954,9,22,30,0
Marvin Webster,1976,1987,7-1,225,1952,12,24,35,0
C.J. Kupec,1976,1978,6-6,220,1953,3,23,25,1
Terry Thomas,1976,1976,6-8,220,1953,1,23,23,1
Dan Roundfield,1976,1987,6-8,205,1953,12,23,34,0
Jim Creighton,1976,1976,6-8,200,1950,1,26,26,1
Joe Bryant,1976,1983,6-9,185,1954,8,22,29,0
Rick Darnell,1976,1976,6-10,215,1953,1,23,23,1
Bob Gross,1976,1983,6-6,200,1953,8,23,30,0
Dave Meyers,1976,1980,6-8,215,1953,5,23,27,0
Glenn Hansen,1976,1978,6-4,205,1952,3,24,26,1
Rudy Hackett,1976,1977,6-9,210,1953,2,23,24,1
Kevin Grevey,1976,1985,6-5,210,1953,10,23,32,0
Lindsay Hairston,1976,1976,6-7,180,1951,1,25,25,1
Steve Green,1976,1979,6-7,220,1953,4,23,26,1
Ticky Burden,1976,1978,6-2,185,1953,3,23,25,1
Ken Smith,1976,1976,6-7,185,1953,1,23,23,1
Mel Bennett,1976,1982,6-7,200,1955,7,21,27,0
Gus Williams,1976,1987,6-2,175,1953,12,23,34,0
John Shumate,1976,1981,6-9,235,1952,6,24,29,0
Gene Short,1976,1976,6-6,200,1953,1,23,23,1
Frank Oleynick,1976,1977,6-2,185,1955,2,21,22,1
Nathaniel Barnett,1976,1976,6-3,175,1953,1,23,23,1
Tom Barker,1977,1979,6-11,225,1955,3,22,24,1
Joe Pace,1977,1978,6-10,220,1953,2,24,25,1
Keith Starr,1977,1977,6-6,190,1954,1,23,23,1
Robin Jones,1977,1978,6-9,225,1954,2,23,24,1
Scott Lloyd,1977,1983,6-10,230,1952,7,25,31,0
Butch Feher,1977,1977,6-4,185,1954,1,23,23,1
Ron Lee,1977,1982,6-4,193,1952,6,25,30,1
Sonny Parker,1977,1982,6-6,200,1955,6,22,27,1
Scott May,1977,1983,6-7,215,1954,7,23,29,0
Ron Davis,1977,1982,6-6,198,1954,6,23,28,1
Johnny Davis,1977,1986,6-2,170,1955,10,22,31,0
Mo Howard,1977,1977,6-2,170,1954,1,23,23,1
Ira Terrell,1977,1979,6-8,200,1954,3,23,25,1
Norton Barnhill,1977,1977,6-4,205,1953,1,24,24,1
Andre McCarter,1977,1981,6-3,190,1953,5,24,28,1
Phil Hicks,1977,1979,6-7,205,1953,3,24,26,1
Terry Furlow,1977,1980,6-4,190,1954,4,23,26,1
Armond Hill,1977,1984,6-4,190,1953,8,24,31,0
Norm Cook,1977,1978,6-8,210,1955,2,22,23,1
Robert Parish,1977,1997,7-0,230,1953,21,24,44,0
John Lucas,1977,1990,6-3,175,1953,14,24,37,0
Larry Wright,1977,1982,6-1,160,1954,6,23,28,1
Cornelius Cash,1977,1977,6-8,215,1952,1,25,25,1
Richard Washington,1977,1982,6-11,220,1955,6,22,27,1
Dennis Johnson,1977,1990,6-4,185,1954,14,23,36,0
Alex English,1977,1991,6-7,190,1954,15,23,37,0
Marshall Rogers,1977,1977,6-1,190,1953,1,24,24,1
Earl Tatum,1977,1980,6-5,185,1953,4,24,27,1
Tom Abernethy,1977,1981,6-7,220,1954,5,23,27,1
Leon Douglas,1977,1983,6-10,230,1954,7,23,29,0
Mike Dunleavy,1977,1990,6-3,180,1954,14,23,36,0
Chuckie Williams,1977,1977,6-3,180,1953,1,24,24,1
Bob Wilkerson,1977,1983,6-6,195,1954,7,23,29,0
Paul Griffin,1977,1983,6-9,205,1954,7,23,29,0
Andy Walker,1977,1977,6-4,190,1955,1,22,22,1
Mitch Kupchak,1977,1986,6-9,230,1954,10,23,32,0
Phil Sellers,1977,1977,6-4,195,1953,1,24,24,1
Lonnie Shelton,1977,1986,6-8,240,1955,10,22,31,0
Lloyd Walton,1977,1981,6-0,160,1953,5,24,28,1
Quinn Buckner,1977,1986,6-3,190,1954,10,23,32,0
Wally Walker,1977,1984,6-7,190,1954,8,23,30,0
Willie Smith,1977,1980,6-2,170,1953,4,24,27,1
Adrian Dantley,1977,1991,6-5,208,1956,15,21,35,0
Mike Glenn,1978,1987,6-2,175,1955,10,23,32,0
Glen Gondrezick,1978,1983,6-6,218,1955,6,23,28,1
Joe Hassett,1978,1983,6-5,180,1955,6,23,28,1
John Kuester,1978,1980,6-2,180,1955,3,23,25,1
Alonzo Bradley,1978,1980,6-6,190,1953,3,25,27,1
Jacky Dorsey,1978,1981,6-7,230,1954,4,24,27,1
Bo Ellis,1978,1980,6-9,197,1954,3,24,26,1
Mark Landsberger,1978,1984,6-8,215,1955,7,23,29,0
Greg Griffin,1978,1978,6-7,190,1952,1,26,26,1
Scott Sims,1978,1978,6-1,170,1955,1,23,23,1
Ricky Marsh,1978,1978,6-3,200,1954,1,24,24,1
Al Fleming,1978,1978,6-7,215,1954,1,24,24,1
Eddie Johnson,1978,1987,6-2,180,1955,10,23,32,0
Larry Johnson,1978,1978,6-3,205,1954,1,24,24,1
Bayard Forrest,1978,1979,6-10,235,1954,2,24,25,1
Marques Johnson,1978,1990,6-7,218,1956,13,22,34,0
T.R. Dunn,1978,1991,6-4,192,1955,14,23,36,0
Toby Knight,1978,1982,6-9,210,1955,5,23,27,1
Charlie Criss,1978,1985,5-8,165,1948,8,30,37,0
Tony Robertson,1978,1979,6-4,195,1956,2,22,23,1
Phil Walker,1978,1978,6-3,180,1956,1,22,22,1
James Edwards,1978,1996,7-0,225,1955,19,23,41,0
Steve Sheppard,1978,1979,6-6,215,1954,2,24,25,1
Wilson Washington,1978,1979,6-9,227,1955,2,23,24,1
Robert Reid,1978,1991,6-8,205,1955,14,23,36,0
Anthony Roberts,1978,1984,6-5,185,1955,7,23,29,0
Rich Laurel,1978,1978,6-6,190,1954,1,24,24,1
Tate Armstrong,1978,1979,6-3,175,1955,2,23,24,1
Glenn Mosley,1978,1979,6-8,195,1955,2,23,24,1
Bob Carrington,1978,1980,6-6,195,1953,3,25,27,1
Rickey Green,1978,1992,6-0,170,1954,15,24,38,0
Kent Benson,1978,1988,6-10,235,1954,11,24,34,0
Wayman Britt,1978,1978,6-2,185,1952,1,26,26,1
Greg Ballard,1978,1989,6-7,215,1955,12,23,34,0
Tom LaGarde,1978,1985,6-10,220,1955,8,23,30,0
Ray Williams,1978,1987,6-3,188,1954,10,24,33,0
Brad Davis,1978,1992,6-3,180,1955,15,23,37,0
Walter Davis,1978,1992,6-6,193,1954,15,24,38,0
Alvin Scott,1978,1985,6-7,185,1955,8,23,30,0
Larry Moffett,1978,1978,6-8,210,1954,1,24,24,1
Bernard King,1978,1993,6-7,205,1956,16,22,37,0
Mark Crow,1978,1978,6-7,210,1954,1,24,24,1
Wesley Cox,1978,1979,6-6,215,1955,2,23,24,1
Cedric Maxwell,1978,1988,6-8,205,1955,11,23,33,0
Otis Birdsong,1978,1989,6-3,190,1955,12,23,34,0
Ernie Grunfeld,1978,1986,6-6,210,1955,9,23,31,0
Phil Bond,1978,1978,6-2,175,1954,1,24,24,1
Jack Sikma,1978,1991,6-11,230,1955,14,23,36,0
Mike Bratz,1978,1986,6-2,185,1955,9,23,31,0
Kenny Carr,1978,1987,6-7,220,1955,10,23,32,0
Norm Nixon,1978,1989,6-2,170,1955,12,23,34,0
Ben Poquette,1978,1987,6-9,235,1955,10,23,32,0
Eddie Owens,1978,1978,6-7,210,1953,1,25,25,1
Jim Bostic,1978,1978,6-7,225,1953,1,25,25,1
Tree Rollins,1978,1995,7-1,235,1955,18,23,40,0
Eddie Jordan,1978,1984,6-1,170,1955,7,23,29,0
Robert Smith,1978,1985,5-11,165,1955,8,23,30,0
Dennis Boyd,1979,1979,6-1,175,1954,1,25,25,1
Bob Elliott,1979,1981,6-9,225,1955,3,24,26,1
Rick Robey,1979,1986,6-11,230,1956,8,23,30,0
Otis Howard,1979,1979,6-7,220,1956,1,23,23,1
Reggie Theus,1979,1991,6-7,190,1957,13,22,34,0
John Rudd,1979,1979,6-7,230,1955,1,24,24,1
Clemon Johnson,1979,1988,6-10,240,1956,10,23,32,0
Butch Lee,1979,1980,6-0,185,1956,2,23,24,1
Mychal Thompson,1979,1991,6-10,226,1955,13,24,36,0
Phil Ford,1979,1985,6-2,175,1956,7,23,29,0
Maurice Cheeks,1979,1993,6-1,180,1956,15,23,37,0
Jackie Robinson,1979,1982,6-6,210,1955,4,24,27,1
Sam Smith,1979,1980,6-4,200,1955,2,24,25,1
Geoff Crompton,1979,1984,6-11,280,1955,6,24,29,1
John Olive,1979,1980,6-7,210,1955,2,24,25,1
Essie Hollis,1979,1979,6-6,195,1955,1,24,24,1
Joel Kramer,1979,1983,6-7,203,1955,5,24,28,1
Lars Hansen,1979,1979,6-10,225,1954,1,25,25,1
John Long,1979,1997,6-5,195,1956,19,23,41,0
Frankie Sanders,1979,1981,6-6,200,1957,3,22,24,1
Ray Epps,1979,1979,6-6,195,1956,1,23,23,1
Winford Boynes,1979,1981,6-6,185,1957,3,22,24,1
Marty Byrnes,1979,1983,6-7,215,1956,5,23,27,1
Kim Anderson,1979,1979,6-7,200,1955,1,24,24,1
Micheal Ray Richardson,1979,1986,6-5,189,1955,8,24,31,0
Michael Cooper,1979,1990,6-5,170,1956,12,23,34,0
Wayne Cooper,1979,1992,6-10,220,1956,14,23,36,0
James Hardy,1979,1982,6-8,220,1956,4,23,26,1
Keith Herron,1979,1982,6-6,195,1956,4,23,26,1
Mike Mitchell,1979,1988,6-7,215,1956,10,23,32,0
Jack Givens,1979,1980,6-5,205,1956,2,23,24,1
Del Beshore,1979,1980,5-11,165,1956,2,23,24,1
George Johnson,1979,1986,6-7,210,1956,8,23,30,0
Roger Phegley,1979,1984,6-6,205,1956,6,23,28,1
Ron Brewer,1979,1986,6-4,180,1955,8,24,31,0
Tommie Green,1979,1979,6-2,185,1956,1,23,23,1
Wayne Radford,1979,1979,6-3,205,1956,1,23,23,1
Billy McKinney,1979,1986,6-0,160,1955,8,24,31,0
Freeman Williams,1979,1986,6-4,190,1956,8,23,30,0
Stan Pietkiewicz,1979,1981,6-5,200,1956,3,23,25,1
Dave Corzine,1979,1991,6-11,250,1956,13,23,35,0
Harry Davis,1979,1980,6-7,220,1956,2,23,24,1
Purvis Short,1979,1990,6-7,210,1957,12,22,33,0
Jeff Judkins,1979,1983,6-6,185,1956,5,23,27,1
Rick Wilson,1979,1980,6-5,200,1956,2,23,24,1
Terry Tyler,1979,1989,6-7,215,1956,11,23,33,0
Marlon Redmond,1979,1980,6-6,188,1955,2,24,25,1
Raymond Townsend,1979,1982,6-3,175,1955,4,24,27,1
Kenny Higgs,1979,1982,6-0,180,1955,4,24,27,1
Andre Wakefield,1979,1980,6-3,175,1955,2,24,25,1
Ron Carter,1979,1980,6-5,190,1956,2,23,24,1
Greg Bunch,1979,1979,6-6,190,1956,1,23,23,1
Jerome Whitehead,1979,1989,6-10,220,1956,11,23,33,0
Greg Deane,1980,1980,6-4,190,1957,1,23,23,1
Paul Dawkins,1980,1980,6-5,190,1957,1,23,23,1
Earl Evans,1980,1980,6-8,202,1955,1,25,25,1
Sylvester Norris,1980,1980,6-11,220,1957,1,23,23,1
Greg Kelser,1980,1985,6-7,190,1957,6,23,28,1
Mike Evans,1980,1988,6-1,170,1955,9,25,33,0
Geoff Huston,1980,1987,6-2,175,1957,8,23,30,0
Cheese Johnson,1980,1980,6-6,195,1957,1,23,23,1
John Coughran,1980,1980,6-7,225,1951,1,29,29,1
Clint Richardson,1980,1987,6-3,195,1956,8,24,31,0
Wiley Peck,1980,1980,6-7,220,1957,1,23,23,1
Sly Williams,1980,1986,6-7,210,1958,7,22,28,0
Bubba Wilson,1980,1980,6-3,175,1955,1,25,25,1
Arvid Kramer,1980,1980,6-9,220,1956,1,24,24,1
Magic Johnson,1980,1996,6-9,215,1959,17,21,37,0
Allen Leavell,1980,1989,6-1,170,1957,10,23,32,0
James Bailey,1980,1988,6-9,220,1957,9,23,31,0
Cliff Robinson,1980,1992,6-9,220,1960,13,20,32,0
Abdul Jeelani,1980,1981,6-8,210,1954,2,26,27,1
Major Jones,1980,1985,6-9,225,1953,6,27,32,1
Roy Hamilton,1980,1981,6-2,180,1957,2,23,24,1
Vinnie Johnson,1980,1992,6-2,200,1956,13,24,36,0
Dudley Bradley,1980,1989,6-6,195,1957,10,23,32,0
Terry Duerod,1980,1983,6-2,180,1956,4,24,27,1
Hollis Copeland,1980,1982,6-6,180,1955,3,25,27,1
Dave Greenwood,1980,1991,6-9,222,1957,12,23,34,0
Pat Cummings,1980,1991,6-9,230,1956,12,24,35,0
Duck Williams,1980,1980,6-2,180,1956,1,24,24,1
Reggie King,1980,1985,6-6,225,1957,6,23,28,1
Lawrence Boston,1980,1980,6-8,225,1956,1,24,24,1
Sam Pellom,1980,1983,6-9,225,1951,4,29,32,1
Bernard Toone,1980,1980,6-9,210,1956,1,24,24,1
Larry Demic,1980,1982,6-9,225,1957,3,23,25,1
Irv Kiffin,1980,1980,6-9,225,1951,1,29,29,1
Jeff Cook,1980,1988,6-10,215,1956,9,24,32,0
Carl Kilpatrick,1980,1980,6-10,230,1956,1,24,24,1
Terry Crosby,1980,1980,6-4,195,1957,1,23,23,1
Gary Garland,1980,1980,6-4,180,1957,1,23,23,1
Steve Malovic,1980,1980,6-10,230,1956,1,24,24,1
Bill Cartwright,1980,1995,7-1,245,1957,16,23,38,0
Tony Zeno,1980,1980,6-8,210,1957,1,23,23,1
Paul Mokeski,1980,1991,7-0,250,1957,12,23,34,0
Ollie Mack,1980,1982,6-3,185,1957,3,23,25,1
Johnny High,1980,1984,6-3,185,1957,5,23,27,1
Jim Spanarkel,1980,1984,6-5,190,1957,5,23,27,1
Calvin Natt,1980,1990,6-6,220,1957,11,23,33,0
Sidney Moncrief,1980,1991,6-3,180,1957,12,23,34,0
Larry Bird,1980,1992,6-9,220,1956,13,24,36,0
Gerald Henderson,1980,1992,6-2,175,1956,13,24,36,0
Brad Holland,1980,1982,6-3,180,1956,3,24,26,1
Jim Paxson,1980,1990,6-6,200,1957,11,23,33,0
Billy Ray Bates,1980,1983,6-4,210,1956,4,24,27,1
Phil Hubbard,1980,1989,6-8,215,1956,10,24,33,0
Wayne Robinson,1981,1981,6-8,217,1958,1,23,23,1
Lewis Brown,1981,1981,6-11,225,1955,1,26,26,1
Tony Jackson,1981,1981,6-0,170,1958,1,23,23,1
Joe Barry Carroll,1981,1991,7-0,225,1958,11,23,33,0
James Donaldson,1981,1995,7-2,275,1957,15,24,38,0
Bill Mayfield,1981,1981,6-7,205,1957,1,24,24,1
Kelvin Ransey,1981,1986,6-1,170,1958,6,23,28,1
Johnny Moore,1981,1990,6-1,175,1958,10,23,32,0
Butch Carter,1981,1986,6-5,180,1958,6,23,28,1
Kenny Natt,1981,1985,6-3,185,1958,5,23,27,1
Wally Rank,1981,1981,6-6,220,1958,1,23,23,1
Walter Jordan,1981,1981,6-7,198,1956,1,25,25,1
Ronnie Lester,1981,1986,6-2,175,1959,6,22,27,1
Ronnie Valentine,1981,1981,6-7,210,1957,1,24,24,1
John Stroud,1981,1981,6-7,215,1957,1,24,24,1
Cedrick Hordges,1981,1982,6-8,220,1957,2,24,25,1
Mike O'Koren,1981,1988,6-7,207,1958,8,23,30,0
James Ray,1981,1983,6-8,215,1957,3,24,26,1
Larry Drew,1981,1991,6-1,170,1958,11,23,33,0
Hawkeye Whitney,1981,1982,6-5,235,1957,2,24,25,1
Edmund Lawrence,1981,1981,7-0,228,1952,1,29,29,1
Carl Nicks,1981,1983,6-1,175,1958,3,23,25,1
Keith McCord,1981,1981,6-7,210,1957,1,24,24,1
Rickey Brown,1981,1985,6-10,215,1958,5,23,27,1
Lowes Moore,1981,1983,6-1,170,1957,3,24,26,1
Lee Johnson,1981,1981,6-11,205,1957,1,24,24,1
Darwin Cook,1981,1989,6-3,184,1958,9,23,31,0
John Duren,1981,1983,6-3,195,1958,3,23,25,1
Andrew Toney,1981,1988,6-3,178,1957,8,24,31,0
DeWayne Scales,1981,1984,6-8,208,1958,4,23,26,1
Myles Patrick,1981,1981,6-8,220,1954,1,27,27,1
Reggie Johnson,1981,1984,6-9,205,1957,4,24,27,1
Bill Hanzlik,1981,1990,6-7,185,1957,10,24,33,0
Sam Worthen,1981,1982,6-5,195,1958,2,23,24,1
Dick Miller,1981,1981,6-6,215,1958,1,23,23,1
Alan Hardy,1981,1982,6-7,195,1957,2,24,25,1
Don Collins,1981,1987,6-6,190,1958,7,23,29,0
Tony Fuller,1981,1981,6-4,180,1958,1,23,23,1
Art Collins,1981,1981,6-4,185,1954,1,27,27,1
Billy Reid,1981,1981,6-5,190,1957,1,24,24,1
Ralph Drollinger,1981,1981,7-2,250,1954,1,27,27,1
Reggie Carter,1981,1982,6-3,175,1957,2,24,25,1
Calvin Garrett,1981,1984,6-7,190,1956,4,25,28,1
Edgar Jones,1981,1986,6-10,225,1956,6,25,30,1
Michael Wiley,1981,1982,6-9,200,1957,2,24,25,1
Mike Niles,1981,1981,6-6,225,1955,1,26,26,1
Darrell Griffith,1981,1991,6-4,190,1958,11,23,33,0
Darrell Allums,1981,1981,6-9,220,1958,1,23,23,1
Kevin McHale,1981,1993,6-10,210,1957,13,24,36,0
Tony Price,1981,1981,6-6,190,1957,1,24,24,1
Mike Harper,1981,1982,6-10,195,1957,2,24,25,1
Wayne Kreklow,1981,1981,6-4,175,1957,1,24,24,1
James Wilkes,1981,1983,6-7,195,1958,3,23,25,1
Wes Matthews,1981,1990,6-1,170,1959,10,22,31,0
Jerry Sichting,1981,1990,6-1,168,1956,10,25,34,0
Jawann Oldham,1981,1991,7-0,215,1957,11,24,34,0
Dave Britton,1981,1981,6-4,180,1958,1,23,23,1
Chad Kinch,1981,1981,6-4,190,1958,1,23,23,1
Mike Woodson,1981,1991,6-5,195,1958,11,23,33,0
Monti Davis,1981,1981,6-7,205,1958,1,23,23,1
Larry Smith,1981,1993,6-8,215,1958,13,23,35,0
Earl Cureton,1981,1997,6-9,210,1957,17,24,40,0
Norman Black,1981,1981,6-5,185,1957,1,24,24,1
Jeff Wilkins,1981,1986,6-11,230,1955,6,26,31,1
Clarence Kea,1981,1982,6-6,218,1959,2,22,23,1
Brett Vroman,1981,1981,7-0,220,1955,1,26,26,1
Mike Gminski,1981,1994,6-11,250,1959,14,22,35,0
Carlos Terry,1981,1983,6-5,210,1956,3,25,27,1
Michael Brooks,1981,1988,6-7,220,1958,8,23,30,0
Rory Sparrow,1981,1992,6-2,175,1958,12,23,34,0
Kiki Vandeweghe,1981,1993,6-8,220,1958,13,23,35,0
Rick Mahorn,1981,1999,6-10,240,1958,19,23,41,0
Kyle Macy,1981,1987,6-3,175,1957,7,24,30,0
Lorenzo Romar,1981,1985,6-1,175,1958,5,23,27,1
Craig Shelton,1981,1982,6-7,210,1957,2,24,25,1
Louis Orr,1981,1988,6-8,175,1958,8,23,30,0
Bill Laimbeer,1981,1994,6-11,245,1957,14,24,37,0
Steve Johnson,1982,1991,6-10,235,1957,10,25,34,0
Mike McGee,1982,1990,6-5,190,1959,9,23,31,0
Carl Bailey,1982,1982,7-0,210,1958,1,24,24,1
Larry Nance,1982,1994,6-10,205,1959,13,23,35,0
Herb Williams,1982,1999,6-10,242,1958,18,24,41,0
Frank Johnson,1982,1994,6-1,185,1958,13,24,36,0
Sam Williams,1982,1985,6-8,210,1959,4,23,26,1
Petur Gudmundsson,1982,1989,7-2,260,1958,8,24,31,0
Brad Branson,1982,1983,6-10,220,1958,2,24,25,1
Eddie Johnson,1982,1999,6-7,215,1959,18,23,40,0
Ray Blume,1982,1982,6-4,185,1958,1,24,24,1
Kurt Nimphius,1982,1990,6-10,218,1958,9,24,32,0
Clay Johnson,1982,1984,6-4,175,1956,3,26,28,1
Ray Tolbert,1982,1989,6-9,225,1958,8,24,31,0
Roger Burkman,1982,1982,6-5,175,1958,1,24,24,1
Craig Dykema,1982,1982,6-8,190,1959,1,23,23,1
Charles Davis,1982,1990,6-7,215,1958,9,24,32,0
Rich Yonakor,1982,1982,6-9,220,1958,1,24,24,1
Rolando Blackman,1982,1994,6-6,190,1959,13,23,35,0
Larry Spriggs,1982,1986,6-7,230,1959,5,23,27,1
Ed Rains,1982,1983,6-7,190,1956,2,26,27,1
Jeff Lamp,1982,1989,6-6,195,1959,8,23,30,0
Kenny Dennard,1982,1984,6-8,220,1958,3,24,26,1
Glenn Hagan,1982,1982,6-0,170,1955,1,27,27,1
Darnell Valentine,1982,1991,6-1,183,1959,10,23,32,0
Danny Ainge,1982,1995,6-4,175,1959,14,23,36,0
Mark Aguirre,1982,1994,6-6,232,1959,13,23,35,0
Rudy Macklin,1982,1984,6-7,205,1958,3,24,26,1
Kevin McKenna,1982,1988,6-5,195,1959,7,23,29,0
Pete Verhoeven,1982,1987,6-9,215,1959,6,23,28,1
Danny Schayes,1982,1999,6-11,235,1959,18,23,40,0
Mickey Dillard,1982,1982,6-3,170,1958,1,24,24,1
Steve Hayes,1982,1986,7-0,205,1955,5,27,31,1
Elston Turner,1982,1989,6-5,190,1959,8,23,30,0
Hank McDowell,1982,1987,6-9,215,1959,6,23,28,1
Jay Vincent,1982,1990,6-7,220,1959,9,23,31,0
John Douglas,1982,1983,6-2,170,1956,2,26,27,1
Joe Cooper,1982,1985,6-10,230,1957,4,25,28,1
Kelly Tripucka,1982,1991,6-6,220,1959,10,23,32,0
John McCullough,1982,1982,6-4,190,1956,1,26,26,1
David Burns,1982,1982,6-2,180,1958,1,24,24,1
Albert King,1982,1992,6-6,190,1959,11,23,33,0
Mark Radford,1982,1983,6-4,190,1959,2,23,24,1
Danny Vranes,1982,1988,6-7,210,1958,7,24,30,0
Jim Brogan,1982,1983,6-4,185,1958,2,24,25,1
Kurt Rambis,1982,1995,6-8,213,1958,14,24,37,0
Jeff Ruland,1982,1993,6-10,240,1958,12,24,35,0
Alton Lister,1982,1998,7-0,240,1958,17,24,40,0
Orlando Woolridge,1982,1994,6-9,215,1959,13,23,35,0
Howard Wood,1982,1982,6-7,235,1959,1,23,23,1
Charles Bradley,1982,1984,6-5,215,1959,3,23,25,1
Jim Smith,1982,1983,6-9,225,1958,2,24,25,1
Garry Witts,1982,1982,6-7,190,1959,1,23,23,1
Franklin Edwards,1982,1988,6-1,170,1959,7,23,29,0
Tracy Jackson,1982,1984,6-6,205,1959,3,23,25,1
Isiah Thomas,1982,1994,6-1,180,1961,13,21,33,0
Tom Chambers,1982,1998,6-10,220,1959,17,23,39,0
Al Wood,1982,1987,6-6,193,1958,6,24,29,1
Kevin Loder,1982,1984,6-6,205,1959,3,23,25,1
Buck Williams,1982,1998,6-8,215,1960,17,22,38,0
Bobby Cattage,1982,1986,6-9,250,1958,5,24,28,1
Lewis Lloyd,1982,1990,6-6,205,1959,9,23,31,0
Alex Bradley,1982,1982,6-6,215,1959,1,23,23,1
Rock Lee,1982,1982,6-10,220,1955,1,27,27,1
Gene Banks,1982,1987,6-7,215,1959,6,23,28,1
Sleepy Floyd,1983,1995,6-3,170,1960,13,23,35,0
Jeff Taylor,1983,1987,6-4,175,1960,5,23,27,1
Trent Tucker,1983,1993,6-5,193,1959,11,24,34,0
Brook Steppe,1983,1989,6-5,195,1959,7,24,30,0
Hutch Jones,1983,1984,6-8,190,1959,2,24,25,1
Bruce Flowers,1983,1983,6-8,225,1957,1,26,26,1
Rod Higgins,1983,1995,6-7,200,1960,13,23,35,0
Guy Morgan,1983,1983,6-8,205,1960,1,23,23,1
Rob Williams,1983,1984,6-2,175,1961,2,22,23,1
Linton Townes,1983,1985,6-7,190,1959,3,24,26,1
Marc Iavaroni,1983,1989,6-8,210,1956,7,27,33,0
Audie Norris,1983,1985,6-9,230,1960,3,23,25,1
Rory White,1983,1987,6-8,210,1959,5,24,28,1
Oliver Robinson,1983,1983,6-4,180,1960,1,23,23,1
Eddie Phillips,1983,1983,6-7,225,1961,1,22,22,1
Chuck Nevitt,1983,1994,7-5,217,1959,12,24,35,0
Chris Engler,1983,1988,6-11,245,1959,6,24,29,1
Walker Russell,1983,1988,6-5,195,1960,6,23,28,1
Dave Batton,1983,1984,6-10,240,1956,2,27,28,1
Fat Lever,1983,1994,6-3,170,1960,12,23,34,0
Clark Kellogg,1983,1987,6-7,225,1961,5,22,26,1
Bill Garnett,1983,1986,6-9,225,1960,4,23,26,1
LaSalle Thompson,1983,1997,6-10,245,1961,15,22,36,0
Cliff Levingston,1983,1995,6-8,210,1961,13,22,34,0
Ricky Pierce,1983,1998,6-4,205,1959,16,24,39,0
John Greig,1983,1983,6-7,215,1961,1,22,22,1
Terry Teagle,1983,1993,6-5,195,1960,11,23,33,0
Derek Smith,1983,1991,6-6,205,1961,9,22,30,0
Corny Thompson,1983,1983,6-8,225,1960,1,23,23,1
Mike Davis,1983,1983,6-10,230,1956,1,27,27,1
Chubby Cox,1983,1983,6-2,180,1955,1,28,28,1
J.J. Anderson,1983,1985,6-8,195,1960,3,23,25,1
Dwight Anderson,1983,1983,6-3,185,1960,1,23,23,1
Bryan Warrick,1983,1986,6-5,195,1959,4,24,27,1
Jim Johnstone,1983,1983,6-11,245,1960,1,23,23,1
Russ Schoene,1983,1989,6-10,210,1960,7,23,29,0
Dominique Wilkins,1983,1999,6-7,200,1960,17,23,39,0
Jose Slaughter,1983,1983,6-5,205,1960,1,23,23,1
John Bagley,1983,1994,6-0,185,1960,12,23,34,0
Quintin Dailey,1983,1992,6-3,180,1961,10,22,31,0
Darren Tillis,1983,1984,6-11,215,1960,2,23,24,1
Craig Hodges,1983,1992,6-2,190,1960,10,23,32,0
Paul Pressey,1983,1993,6-5,185,1958,11,25,35,0
Mark Eaton,1983,1993,7-4,275,1957,11,26,36,0
Ed Nealy,1983,1993,6-7,238,1960,11,23,33,0
Mike Sanders,1983,1993,6-6,210,1960,11,23,33,0
Jerry Eaves,1983,1987,6-4,180,1959,5,24,28,1
David Thirdkill,1983,1987,6-7,195,1960,5,23,27,1
Steve Lingenfelter,1983,1984,6-9,225,1958,2,25,26,1
James Worthy,1983,1994,6-9,225,1961,12,22,33,0
Richard Anderson,1983,1990,6-10,240,1960,8,23,30,0
Charles Pittman,1983,1986,6-8,220,1958,4,25,28,1
Dave Magley,1983,1983,6-8,202,1959,1,24,24,1
Keith Edmonson,1983,1984,6-5,195,1960,2,23,24,1
Rickey Williams,1983,1983,6-1,175,1957,1,26,26,1
Lester Conner,1983,1995,6-4,180,1959,13,24,36,0
Joe Kopicki,1983,1985,6-9,240,1960,3,23,25,1
Ed Sherod,1983,1983,6-2,170,1959,1,24,24,1
Jim Zoet,1983,1983,7-1,240,1953,1,30,30,1
Vince Taylor,1983,1983,6-5,180,1960,1,23,23,1
Terry Cummings,1983,2000,6-9,220,1961,18,22,39,0
Scott Hastings,1983,1993,6-10,235,1960,11,23,33,0
Mark McNamara,1983,1991,6-11,235,1959,9,24,32,0
Rod Foster,1984,1986,6-1,160,1960,3,24,26,1
Darrell Lockhart,1984,1984,6-9,245,1960,1,24,24,1
Sidney Green,1984,1993,6-9,220,1961,10,23,32,0
Darrell Walker,1984,1993,6-4,180,1961,10,23,32,0
Larry Micheaux,1984,1985,6-9,220,1960,2,24,25,1
John Garris,1984,1984,6-8,205,1959,1,25,25,1
Doc Rivers,1984,1996,6-4,185,1961,13,23,35,0
Paul Thompson,1984,1986,6-6,210,1961,3,23,25,1
Pace Mannion,1984,1989,6-7,190,1960,6,24,29,1
Kevin Williams,1984,1989,6-2,175,1961,6,23,28,1
Steve Stipanovich,1984,1988,6-11,245,1960,5,24,28,1
Michael Wilson,1984,1987,6-4,175,1959,4,25,28,1
Rodney McCray,1984,1993,6-7,220,1961,10,23,32,0
Mitchell Wiggins,1984,1992,6-4,185,1959,9,25,33,0
Wallace Bryant,1984,1986,7-0,245,1959,3,25,27,1
Jon Sundvold,1984,1992,6-2,170,1961,9,23,31,0
Ken Austin,1984,1984,6-9,205,1961,1,23,23,1
John Paxson,1984,1994,6-2,185,1960,11,24,34,0
Bob Miller,1984,1984,6-10,230,1956,1,28,28,1
Thurl Bailey,1984,1999,6-11,215,1961,16,23,38,0
Randy Wittman,1984,1992,6-6,210,1959,9,25,33,0
Darren Daye,1984,1988,6-8,220,1960,5,24,28,1
Bob Hansen,1984,1992,6-6,190,1961,9,23,31,0
Byron Scott,1984,1997,6-3,195,1961,14,23,36,0
Mark West,1984,2000,6-10,230,1960,17,24,40,0
Leroy Combs,1984,1984,6-8,210,1961,1,23,23,1
Carlos Clark,1984,1985,6-4,210,1960,2,24,25,1
Granville Waiters,1984,1988,6-11,225,1961,5,23,27,1
Fred Roberts,1984,1997,6-10,218,1960,14,24,37,0
Ralph Sampson,1984,1992,7-4,228,1960,9,24,32,0
Roy Hinson,1984,1991,6-9,210,1961,8,23,30,0
Howard Carter,1984,1985,6-5,215,1961,2,23,24,1
Clyde Drexler,1984,1998,6-7,210,1962,15,22,36,0
Brant Weidner,1984,1984,6-9,230,1960,1,24,24,1
Stewart Granger,1984,1987,6-3,190,1961,4,23,26,1
Jeff Malone,1984,1996,6-4,205,1961,13,23,35,0
Dale Ellis,1984,2000,6-7,205,1960,17,24,40,0
Charles Jones,1984,1998,6-9,215,1957,15,27,41,0
Randy Breuer,1984,1994,7-3,230,1960,11,24,34,0
Sidney Lowe,1984,1990,6-0,195,1960,7,24,30,0
Scooter McCray,1984,1987,6-9,215,1960,4,24,27,1
Greg Kite,1984,1995,6-11,250,1961,12,23,34,0
Craig Ehlo,1984,1997,6-6,180,1961,14,23,36,0
Leo Rautins,1984,1985,6-8,215,1960,2,24,25,1
John Pinone,1984,1984,6-8,230,1961,1,23,23,1
Ennis Whatley,1984,1997,6-3,177,1962,14,22,35,0
Sedale Threatt,1984,1997,6-2,175,1961,14,23,36,0
Bruce Kuczenski,1984,1984,6-10,230,1961,1,23,23,1
Mike Gibson,1984,1986,6-10,205,1960,3,24,26,1
Derek Harper,1984,1999,6-4,185,1961,16,23,38,0
Dane Suttle,1984,1985,6-3,190,1961,2,23,24,1
Mark Jones,1984,1984,6-1,175,1961,1,23,23,1
Russell Cross,1984,1984,6-10,215,1961,1,23,23,1
Tom Piotrowski,1984,1984,7-1,240,1960,1,24,24,1
Jim Thomas,1984,1991,6-3,190,1960,8,24,31,0
Tom Sluby,1985,1985,6-4,200,1962,1,23,23,1
Hakeem Olajuwon,1985,2002,7-0,255,1963,18,22,39,0
Kevin Willis,1985,2007,7-0,220,1962,23,23,45,0
Gary Plummer,1985,1993,6-9,215,1962,9,23,31,0
Jay Humphries,1985,1995,6-3,185,1962,11,23,33,0
Tom Sewell,1985,1985,6-5,185,1962,1,23,23,1
Danny Young,1985,1995,6-3,175,1962,11,23,33,0
David Pope,1985,1986,6-7,220,1962,2,23,24,1
Rick Carlisle,1985,1990,6-5,210,1959,6,26,31,1
Peter Thibeaux,1985,1986,6-7,210,1961,2,24,25,1
Michael Young,1985,1990,6-7,220,1961,6,24,29,1
Dale Wilkinson,1985,1985,6-10,220,1960,1,25,25,1
Jerome Kersey,1985,2001,6-7,215,1962,17,23,39,0
Leon Wood,1985,1991,6-3,185,1962,7,23,29,0
Tony Campbell,1985,1995,6-7,215,1962,11,23,33,0
Bernard Thompson,1985,1989,6-6,210,1962,5,23,27,1
Kenny Fields,1985,1988,6-5,220,1962,4,23,26,1
Jay Murphy,1985,1988,6-9,220,1962,4,23,26,1
Butch Graves,1985,1985,6-3,200,1962,1,23,23,1
Tony Brown,1985,1992,6-6,185,1960,8,25,32,0
Jeff Turner,1985,1996,6-9,230,1962,12,23,34,0
Ozell Jones,1985,1986,6-11,235,1960,2,25,26,1
Charles Barkley,1985,2000,6-6,252,1963,16,22,37,0
Sam Bowie,1985,1995,7-1,235,1961,11,24,34,0
Cory Blackwell,1985,1985,6-6,210,1963,1,22,22,1
Vern Fleming,1985,1996,6-5,185,1962,12,23,34,0
Earl Jones,1985,1986,7-0,210,1961,2,24,25,1
Tom Scheffler,1985,1985,6-11,240,1954,1,31,31,1
Charles Jones,1985,1989,6-8,215,1962,5,23,27,1
Ken Bannister,1985,1991,6-9,235,1960,7,25,31,0
Lancaster Gordon,1985,1988,6-3,185,1962,4,23,26,1
Michael Cage,1985,2000,6-9,224,1962,16,23,38,0
Mike Holton,1985,1990,6-4,185,1961,6,24,29,1
Otis Thorpe,1985,2001,6-9,225,1962,17,23,39,0
John Stockton,1985,2003,6-1,170,1962,19,23,41,0
Alvin Robertson,1985,1996,6-3,185,1962,12,23,34,0
Willie White,1985,1986,6-3,195,1962,2,23,24,1
Devin Durrant,1985,1986,6-7,200,1960,2,25,26,1
Ron Anderson,1985,1994,6-7,215,1958,10,27,36,0
Steve Burtt,1985,1993,6-2,185,1962,9,23,31,0
Chuck Aleksinas,1985,1985,6-11,260,1959,1,26,26,1
Eddie Lee Wilkins,1985,1993,6-10,220,1962,9,23,31,0
Steve Colter,1985,1995,6-3,165,1962,11,23,33,0
Jim Petersen,1985,1992,6-10,235,1962,8,23,30,0
Tim McCormick,1985,1992,6-11,240,1962,8,23,30,0
Kenton Edelin,1985,1985,6-8,205,1962,1,23,23,1
Wayne Sappleton,1985,1985,6-9,215,1960,1,25,25,1
Terence Stansbury,1985,1987,6-5,170,1961,3,24,26,1
Stuart Gray,1985,1991,7-0,235,1963,7,22,28,0
Ron Cavenall,1985,1989,7-1,230,1959,5,26,30,1
Melvin Turpin,1985,1990,6-11,240,1960,6,25,30,1
Charlie Sitton,1985,1985,6-8,210,1962,1,23,23,1
Antoine Carr,1985,2000,6-9,225,1961,16,24,39,0
Sam Perkins,1985,2001,6-9,235,1961,17,24,40,0
Frank Brickowski,1985,1997,6-9,240,1959,13,26,38,0
Othell Wilson,1985,1987,6-0,190,1961,3,24,26,1
Guy Williams,1985,1986,6-9,200,1960,2,25,26,1
Michael Jordan,1985,2003,6-6,195,1963,19,22,40,0
John Schweitz,1985,1987,6-6,210,1960,3,25,27,1
Ralph Jackson,1985,1985,6-2,190,1962,1,23,23,1
Chris McNealy,1986,1988,6-7,210,1961,3,25,27,1
Keith Lee,1986,1989,6-10,215,1962,4,24,27,1
Jerry Reynolds,1986,1996,6-8,200,1962,11,24,34,0
Yvon Joseph,1986,1986,6-11,245,1957,1,29,29,1
Ken Johnson,1986,1986,6-8,240,1962,1,24,24,1
Alfredrick Hughes,1986,1986,6-5,215,1962,1,24,24,1
Sedric Toney,1986,1994,6-2,178,1962,9,24,32,0
Jeff Cross,1986,1986,6-10,240,1961,1,25,25,1
Nick Vanos,1986,1987,7-1,255,1963,2,23,24,1
Joe Kleine,1986,2000,6-11,255,1962,15,24,38,0
A.C. Green,1986,2001,6-9,220,1963,16,23,38,0
Terry Porter,1986,2002,6-3,195,1963,17,23,39,0
Chris Mullin,1986,2001,6-6,200,1963,16,23,38,0
Wayman Tisdale,1986,1997,6-9,240,1964,12,22,33,0
Jon Koncak,1986,1996,7-0,250,1963,11,23,33,0
Steve Harris,1986,1990,6-5,195,1963,5,23,27,1
Tyrone Corbin,1986,2001,6-6,210,1962,16,24,39,0
Harold Keeling,1986,1986,6-4,185,1963,1,23,23,1
John Battle,1986,1995,6-2,175,1962,10,24,33,0
Lorenzo Charles,1986,1986,6-7,225,1963,1,23,23,1
Pete Williams,1986,1987,6-7,190,1965,2,21,22,1
Michael Adams,1986,1996,5-10,162,1963,11,23,33,0
Mike Brittain,1986,1987,7-0,235,1963,2,23,24,1
Gerald Wilkins,1986,1999,6-6,185,1963,14,23,36,0
Bill Martin,1986,1988,6-7,205,1962,3,24,26,1
Ron Crevier,1986,1986,7-0,235,1958,1,28,28,1
Terry Catledge,1986,1993,6-8,220,1963,8,23,30,0
Spud Webb,1986,1998,5-6,133,1963,13,23,35,0
Carl Henry,1986,1986,6-6,205,1960,1,26,26,1
Georgi Glouchkov,1986,1986,6-8,235,1960,1,26,26,1
Blair Rasmussen,1986,1993,7-0,250,1962,8,24,31,0
Manute Bol,1986,1995,7-7,200,1962,10,24,33,0
Carey Scurry,1986,1988,6-7,188,1962,3,24,26,1
Charles Oakley,1986,2004,6-8,225,1963,19,23,41,0
Michael Phelps,1986,1988,6-4,180,1961,3,25,27,1
Detlef Schrempf,1986,2001,6-9,214,1963,16,23,38,0
Voise Winters,1986,1986,6-8,200,1962,1,24,24,1
Xavier McDaniel,1986,1998,6-7,205,1963,13,23,35,0
Sam Vincent,1986,1992,6-2,185,1963,7,23,29,0
Fred Cofield,1986,1987,6-3,190,1962,2,24,25,1
Dwayne McClain,1986,1986,6-6,185,1963,1,23,23,1
Karl Malone,1986,2004,6-9,250,1963,19,23,41,0
Ed Pinckney,1986,1997,6-9,195,1963,12,23,34,0
Bob Thornton,1986,1996,6-10,225,1962,11,24,34,0
Derrick Rowland,1986,1986,6-5,195,1959,1,27,27,1
Patrick Ewing,1986,2002,7-0,240,1962,17,24,40,0
Ben McDonald,1986,1989,6-8,210,1962,4,24,27,1
David Cooke,1986,1986,6-8,230,1963,1,23,23,1
Benoit Benjamin,1986,2000,7-0,250,1964,15,22,36,0
Kenny Green,1986,1987,6-6,210,1964,2,22,23,1
Brian Martin,1986,1986,6-9,212,1962,1,24,24,1
Ken Green,1986,1986,6-8,215,1959,1,27,27,1
Uwe Blab,1986,1990,7-1,252,1962,5,24,28,1
Mike Smrek,1986,1992,7-0,250,1962,7,24,30,0
Alex Stivrins,1986,1993,6-8,220,1962,8,24,31,0
Claude Gregory,1986,1988,6-8,205,1958,3,28,30,1
Joe Dumars,1986,1999,6-3,190,1963,14,23,36,0
Bill Wennington,1986,2000,7-0,245,1963,15,23,37,0
Perry Moss,1986,1987,6-2,185,1958,2,28,29,1
Greg Stokes,1986,1990,6-10,220,1963,5,23,27,1
Dirk Minniefield,1986,1988,6-3,180,1961,3,25,27,1
Jerome Henderson,1986,1987,6-11,230,1959,2,27,28,1
Chuck Person,1987,2000,6-8,220,1964,14,23,36,0
Larry Krystkowiak,1987,1997,6-9,220,1964,11,23,33,0
Dennis Nutt,1987,1987,6-2,170,1963,1,24,24,1
John Williams,1987,1995,6-8,235,1966,9,21,29,0
Hot Rod Williams,1987,1999,6-11,215,1962,13,25,37,0
Jim Lampley,1987,1987,6-10,230,1960,1,27,27,1
Ben Coleman,1987,1994,6-9,235,1961,8,26,33,0
Chris Washburn,1987,1988,6-11,225,1965,2,22,23,1
Mike Brown,1987,1997,6-9,257,1963,11,24,34,0
Pearl Washington,1987,1989,6-2,190,1964,3,23,25,1
Maurice Martin,1987,1988,6-6,200,1964,2,23,24,1
Dwayne Polee,1987,1987,6-5,180,1963,1,24,24,1
William Bedford,1987,1993,7-0,225,1963,7,24,30,0
Fernando Martin,1987,1987,6-9,220,1962,1,25,25,1
Johnny Newman,1987,2002,6-7,190,1963,16,24,39,0
Johnny Dawkins,1987,1995,6-2,165,1963,9,24,32,0
Dave Feitl,1987,1992,6-11,235,1962,6,25,30,1
Brad Sellers,1987,1993,7-0,210,1962,7,25,31,0
Joe Binion,1987,1987,6-8,235,1961,1,26,26,1
Nate McMillan,1987,1998,6-5,195,1964,12,23,34,0
Clinton Smith,1987,1991,6-6,210,1964,5,23,27,1
Grant Gondrezick,1987,1989,6-5,205,1963,3,24,26,1
Ron Rowan,1987,1987,6-5,200,1962,1,25,25,1
Andre Turner,1987,1992,5-11,160,1964,6,23,28,1
Bruce Douglas,1987,1987,6-3,195,1964,1,23,23,1
Billy Thompson,1987,1992,6-7,195,1963,6,24,29,1
Greg Dreiling,1987,1997,7-1,250,1962,11,25,35,0
Otis Smith,1987,1992,6-5,210,1964,6,23,28,1
Anthony Jones,1987,1990,6-6,195,1962,4,25,28,1
Kevin Duckworth,1987,1997,7-0,275,1964,11,23,33,0
Perry Young,1987,1987,6-5,210,1963,1,24,24,1
Johnny Rogers,1987,1988,6-10,225,1963,2,24,25,1
Dennis Rodman,1987,2000,6-7,210,1961,14,26,39,0
Steffond Johnson,1987,1987,6-8,240,1962,1,25,25,1
Myron Jackson,1987,1987,6-3,185,1964,1,23,23,1
Ron Harper,1987,2001,6-6,185,1964,15,23,37,0
Walter Berry,1987,1989,6-8,215,1964,3,23,25,1
Adrian Branch,1987,1990,6-7,185,1963,4,24,27,1
Buck Johnson,1987,1993,6-7,190,1964,7,23,29,0
Cozell McQueen,1987,1987,6-11,235,1962,1,25,25,1
Rafael Addison,1987,1997,6-7,215,1964,11,23,33,0
Keith Smith,1987,1987,6-3,180,1964,1,23,23,1
Jeff Hornacek,1987,2000,6-3,190,1963,14,24,37,0
Tim Kempton,1987,1998,6-10,245,1964,12,23,34,0
David Wingate,1987,2001,6-5,185,1963,15,24,38,0
Forrest McKenzie,1987,1987,6-7,200,1963,1,24,24,1
Conner Henry,1987,1988,6-7,195,1963,2,24,25,1
Kenny Walker,1987,1995,6-8,210,1964,9,23,31,0
Pete Myers,1987,1998,6-6,180,1963,12,24,35,0
Kevin Henderson,1987,1988,6-4,195,1964,2,23,24,1
Dell Curry,1987,2002,6-4,190,1964,16,23,38,0
Cedric Henderson,1987,1987,6-8,210,1965,1,22,22,1
Curtis Kitchen,1987,1987,6-9,235,1964,1,23,23,1
Harold Pressley,1987,1990,6-7,210,1963,4,24,27,1
Brad Daugherty,1987,1994,7-0,245,1965,8,22,29,0
McKinley Singleton,1987,1987,6-5,175,1961,1,26,26,1
Brad Wright,1987,1988,6-11,225,1962,2,25,26,1
Mark Alarie,1987,1991,6-8,217,1963,5,24,28,1
Scott Skiles,1987,1996,6-1,180,1964,10,23,32,0
Mark Price,1987,1998,6-0,170,1964,12,23,34,0
Kenny Gattison,1987,1996,6-8,225,1964,10,23,32,0
John Salley,1987,2000,6-11,230,1964,14,23,36,0
Roy Tarpley,1987,1995,6-11,230,1964,9,23,31,0
Brian Rowsom,1988,1990,6-9,220,1965,3,23,25,1
Dennis Hopson,1988,1992,6-5,200,1965,5,23,27,1
Mark Jackson,1988,2004,6-1,180,1965,17,23,39,0
Michael Jackson,1988,1990,6-2,183,1964,3,24,26,1
Dave Henderson,1988,1988,6-5,195,1964,1,24,24,1
Clinton Wheeler,1988,1989,6-1,185,1959,2,29,30,1
Norris Coleman,1988,1988,6-8,210,1961,1,27,27,1
Rickie Winslow,1988,1988,6-8,225,1964,1,24,24,1
Kenny Smith,1988,1997,6-3,170,1965,10,23,32,0
Kevin Gamble,1988,1997,6-5,210,1965,10,23,32,0
Brad Lohaus,1988,1998,6-11,230,1964,11,24,34,0
Winston Garland,1988,1995,6-2,170,1964,8,24,31,0
Muggsy Bogues,1988,2001,5-3,136,1965,14,23,36,0
Eric White,1988,1989,6-8,200,1965,2,23,24,1
Nate Blackwell,1988,1988,6-4,170,1965,1,23,23,1
Tellis Frank,1988,1994,6-10,225,1965,7,23,29,0
Armen Gilliam,1988,2000,6-9,230,1964,13,24,36,0
Martin Nessley,1988,1988,7-2,260,1965,1,23,23,1
Joe Wolf,1988,1999,6-11,230,1964,12,24,35,0
Joe Arlauckas,1988,1988,6-9,230,1965,1,23,23,1
Chris Welp,1988,1990,7-0,245,1964,3,24,26,1
Steve Alford,1988,1991,6-2,183,1964,4,24,27,1
Reggie Lewis,1988,1993,6-7,195,1965,6,23,28,1
Scott Roth,1988,1990,6-8,212,1963,3,25,27,1
Tony White,1988,1988,6-2,170,1965,1,23,23,1
Vincent Askew,1988,1998,6-6,210,1966,11,22,32,0
Ralph Lewis,1988,1990,6-6,200,1963,3,25,27,1
Jim Farmer,1988,1994,6-4,190,1964,7,24,30,0
Dave Hoppen,1988,1993,6-11,235,1964,6,24,29,1
Andre Moore,1988,1988,6-9,215,1964,1,24,24,1
John Stroeder,1988,1989,6-10,260,1958,2,30,31,1
Eddie Hughes,1988,1990,5-10,165,1960,3,28,30,1
Tod Murphy,1988,1994,6-9,220,1963,7,25,31,0
Reggie Miller,1988,2005,6-7,185,1965,18,23,40,0
Ronnie Murphy,1988,1988,6-5,225,1964,1,24,24,1
Olden Polynice,1988,2004,6-11,220,1964,17,24,40,0
Jamie Waller,1988,1988,6-4,215,1964,1,24,24,1
Greg Anderson,1988,1998,6-10,230,1964,11,24,34,0
Ricky Wilson,1988,1988,6-3,195,1964,1,24,24,1
Reggie Williams,1988,1997,6-7,190,1964,10,24,33,0
Richard Rellford,1988,1988,6-6,230,1964,1,24,24,1
Derrick McKey,1988,2002,6-9,205,1966,15,22,36,0
Kevin Johnson,1988,2000,6-1,180,1966,13,22,34,0
Kannard Johnson,1988,1988,6-9,220,1965,1,23,23,1
Phil Zevenbergen,1988,1988,6-10,230,1964,1,24,24,1
Ken Norman,1988,1997,6-8,215,1964,10,24,33,0
Billy Donovan,1988,1988,5-11,171,1965,1,23,23,1
Scottie Pippen,1988,2004,6-8,210,1965,17,23,39,0
Ron Moore,1988,1988,7-0,260,1962,1,26,26,1
Chris Dudley,1988,2003,6-11,235,1965,16,23,38,0
Horace Grant,1988,2004,6-10,215,1965,17,23,39,0
Duane Washington,1988,1993,6-4,195,1964,6,24,29,1
Mark Wade,1988,1990,5-11,160,1965,3,23,25,1
Nikita Wilson,1988,1988,6-8,200,1964,1,24,24,1
Winston Crite,1988,1989,6-7,233,1965,2,23,24,1
Mark Acres,1988,1993,6-11,220,1962,6,26,31,1
Milt Wagner,1988,1991,6-5,185,1963,4,25,28,1
Bart Kofoed,1988,1993,6-4,210,1964,6,24,29,1
Dallas Comegys,1988,1989,6-9,205,1964,2,24,25,1
Rob Lock,1989,1989,6-9,225,1966,1,23,23,1
Rony Seikaly,1989,1999,6-11,230,1965,11,24,34,0
Derrick Chievous,1989,1991,6-7,195,1967,3,22,24,1
Craig Neal,1989,1991,6-5,165,1964,3,25,27,1
Mark Bryant,1989,2003,6-9,245,1965,15,24,38,0
Vernon Maxwell,1989,2001,6-4,180,1965,13,24,36,0
Rolando Ferreira,1989,1989,7-1,240,1964,1,25,25,1
Grant Long,1989,2003,6-8,225,1966,15,23,37,0
Ben Gillery,1989,1989,7-0,235,1965,1,24,24,1
Hersey Hawkins,1989,2001,6-3,190,1966,13,23,35,0
Charles Smith,1989,1997,6-10,230,1965,9,24,32,0
Morlon Wiley,1989,1995,6-4,185,1966,7,23,29,0
Duane Ferrell,1989,1999,6-7,209,1965,11,24,34,0
Tim Perry,1989,1996,6-9,200,1965,8,24,31,0
Mike Champion,1989,1989,6-10,230,1964,1,25,25,1
Jack Haley,1989,1998,6-10,240,1964,10,25,34,0
Everette Stephens,1989,1991,6-2,175,1966,3,23,25,1
Corey Gaines,1989,1995,6-3,195,1965,7,24,30,0
Dave Popson,1989,1992,6-10,220,1964,4,25,28,1
Todd Mitchell,1989,1989,6-7,205,1966,1,23,23,1
Richard Morton,1989,1989,6-3,190,1966,1,23,23,1
Anthony Frederick,1989,1992,6-7,205,1964,4,25,28,1
Tom Garrick,1989,1992,6-2,185,1966,4,23,26,1
Randy Allen,1989,1990,6-8,220,1965,2,24,25,1
Jose Ortiz,1989,1990,6-10,225,1963,2,26,27,1
Anthony Taylor,1989,1989,6-4,175,1965,1,24,24,1
Dominic Pressley,1989,1989,6-2,170,1964,1,25,25,1
Keith Smart,1989,1989,6-1,175,1964,1,25,25,1
Scott Brooks,1989,1998,5-11,165,1965,10,24,33,0
Barry Sumpter,1989,1989,6-11,215,1965,1,24,24,1
Randolph Keys,1989,1996,6-7,195,1966,8,23,30,0
Steve Kerr,1989,2003,6-3,175,1965,15,24,38,0
Mark Davis,1989,1989,6-6,195,1963,1,26,26,1
Vinny Del Negro,1989,2002,6-4,185,1966,14,23,36,0
Tito Horford,1989,1994,7-1,245,1966,6,23,28,1
Rex Chapman,1989,2000,6-4,185,1967,12,22,33,0
Rod Strickland,1989,2005,6-3,175,1966,17,23,39,0
Fennis Dembo,1989,1989,6-5,215,1966,1,23,23,1
Rik Smits,1989,2000,7-4,250,1966,12,23,34,0
Chris Morris,1989,1999,6-8,210,1966,11,23,33,0
Jim Les,1989,1995,5-11,165,1963,7,26,32,0
Michael Anderson,1989,1989,5-11,184,1966,1,23,23,1
Anthony Bowie,1989,1998,6-6,190,1963,10,26,35,0
Ledell Eackles,1989,1998,6-5,220,1966,10,23,32,0
Tom Tolbert,1989,1995,6-7,235,1965,7,24,30,0
Micheal Williams,1989,1999,6-2,175,1966,11,23,33,0
Orlando Graham,1989,1989,6-8,220,1965,1,24,24,1
Mitch Richmond,1989,2002,6-5,215,1965,14,24,37,0
Avery Johnson,1989,2004,5-10,175,1965,16,24,39,0
Kevin Edwards,1989,2001,6-3,190,1965,13,24,36,0
Harvey Grant,1989,1999,6-8,195,1965,11,24,34,0
Danny Manning,1989,2003,6-10,230,1966,15,23,37,0
Ricky Berry,1989,1989,6-8,205,1964,1,25,25,1
David Rivers,1989,1992,6-0,170,1965,4,24,27,1
Ramon Rivas,1989,1989,6-10,260,1966,1,23,23,1
Ron Grandison,1989,1996,6-6,215,1964,8,25,32,0
Gary Grant,1989,2001,6-3,185,1965,13,24,36,0
Brian Shaw,1989,2003,6-6,190,1966,15,23,37,0
Wayne Englestad,1989,1989,6-8,245,1966,1,23,23,1
Will Perdue,1989,2001,7-0,240,1965,13,24,36,0
Jeff Grayer,1989,1998,6-5,200,1965,10,24,33,0
Eric Leckner,1989,1997,6-11,265,1966,9,23,31,0
Willie Anderson,1989,1997,6-7,190,1967,9,22,30,0
Kelvin Upshaw,1989,1991,6-2,180,1963,3,26,28,1
Shelton Jones,1989,1989,6-9,210,1966,1,23,23,1
Jim Rowinski,1989,1990,6-8,250,1961,2,28,29,1
Jerome Lane,1989,1993,6-6,230,1966,5,23,27,1
Andrew Lang,1989,2000,6-11,245,1966,12,23,34,0
Charles Shackleford,1989,1999,6-10,225,1966,11,23,33,0
David Wood,1989,1997,6-9,227,1964,9,25,33,0
Dan Majerle,1989,2002,6-6,215,1965,14,24,37,0
Sylvester Gray,1989,1989,6-6,230,1967,1,22,22,1
John Shasky,1989,1991,6-11,235,1964,3,25,27,1
John Starks,1989,2002,6-3,180,1965,14,24,37,0
Bill Jones,1989,1989,6-7,175,1966,1,23,23,1
Greg Butler,1989,1991,6-11,240,1966,3,23,25,1
Rob Rose,1989,1989,6-5,180,1964,1,25,25,1
Adrian Caldwell,1990,1998,6-8,265,1966,9,24,32,0
Michael Smith,1990,1995,6-10,225,1965,6,25,30,1
Sam Mitchell,1990,2002,6-6,210,1963,13,27,39,0
Charles Smith,1990,1996,6-1,160,1967,7,23,29,0
Sarunas Marciulionis,1990,1997,6-5,200,1964,8,26,33,0
John Morton,1990,1992,6-3,180,1967,3,23,25,1
Nick Anderson,1990,2002,6-6,205,1968,13,22,34,0
Greg Grant,1990,1996,5-7,140,1966,7,24,30,0
Derrick Gervin,1990,1991,6-8,200,1963,2,27,28,1
Mike Morrison,1990,1990,6-4,195,1967,1,23,23,1
Winston Bennett,1990,1992,6-7,210,1965,3,25,27,1
Roy Marble,1990,1994,6-6,190,1966,5,24,28,1
Tim Hardaway,1990,2003,6-0,175,1966,14,24,37,0
Jeff Martin,1990,1991,6-5,195,1967,2,23,24,1
Steve Bucknall,1990,1990,6-6,215,1966,1,24,24,1
Dexter Shouse,1990,1990,6-2,200,1963,1,27,27,1
Scott Haffner,1990,1991,6-3,180,1966,2,24,25,1
Anthony Mason,1990,2003,6-7,250,1966,14,24,37,0
Tom Hammonds,1990,2001,6-9,215,1967,12,23,34,0
Mel McCants,1990,1990,6-8,240,1967,1,23,23,1
David Robinson,1990,2003,7-1,235,1965,14,25,38,0
Dyron Nix,1990,1990,6-7,210,1967,1,23,23,1
Glen Rice,1990,2004,6-7,215,1967,15,23,37,0
Eric Johnson,1990,1990,6-2,205,1966,1,24,24,1
Pooh Richardson,1990,1999,6-1,180,1966,10,24,33,0
Jeff Lebo,1990,1990,6-2,180,1966,1,24,24,1
Blue Edwards,1990,1999,6-4,200,1965,10,25,34,0
J.R. Reid,1990,2001,6-9,247,1968,12,22,33,0
Raymond Brown,1990,1990,6-8,220,1965,1,25,25,1
Jay Edwards,1990,1990,6-4,185,1969,1,21,21,1
George McCloud,1990,2002,6-6,205,1967,13,23,35,0
Scott Meents,1990,1991,6-10,225,1964,2,26,27,1
Clifford Robinson,1990,2007,6-10,225,1966,18,24,41,0
Dana Barros,1990,2004,5-11,163,1967,15,23,37,0
Tim Legler,1990,2000,6-4,200,1966,11,24,34,0
Mike Williams,1990,1990,6-8,255,1963,1,27,27,1
Drazen Petrovic,1990,1993,6-5,195,1964,4,26,29,1
Terry Dozier,1990,1990,6-9,210,1966,1,24,24,1
Sherman Douglas,1990,2001,6-0,180,1966,12,24,35,0
Frank Kornet,1990,1991,6-9,225,1967,2,23,24,1
Chucky Brown,1990,2002,6-7,214,1968,13,22,34,0
Stacey King,1990,1997,6-11,230,1967,8,23,30,0
Alexander Volkov,1990,1992,6-10,218,1964,3,26,28,1
Gary Voce,1990,1990,6-9,240,1965,1,25,25,1
Stan Kimbrough,1990,1993,5-11,153,1966,4,24,27,1
Terry Davis,1990,2001,6-9,225,1967,12,23,34,0
Shawn Kemp,1990,2003,6-10,230,1969,14,21,34,0
Brian Quinnett,1990,1992,6-8,235,1966,3,24,26,1
Carlton McKinney,1990,1992,6-4,190,1964,3,26,28,1
Lanard Copeland,1990,1992,6-6,190,1965,3,25,27,1
Michael Ansley,1990,1992,6-7,225,1967,3,23,25,1
Byron Dinkins,1990,1991,6-1,170,1967,2,23,24,1
Vlade Divac,1990,2005,7-1,243,1968,16,22,37,0
Henry Turner,1990,1995,6-7,200,1966,6,24,29,1
Sean Elliott,1990,2001,6-8,205,1968,12,22,33,0
Gary Leonard,1990,1992,7-1,250,1967,3,23,25,1
Nate Johnston,1990,1990,6-8,210,1966,1,24,24,1
Clifford Lett,1990,1991,6-3,170,1965,2,25,26,1
Mike Higgins,1990,1991,6-9,220,1967,2,23,24,1
Zarko Paspalj,1990,1990,6-9,215,1966,1,24,24,1
Mookie Blaylock,1990,2002,6-0,180,1967,13,23,35,0
Torgeir Bryn,1990,1990,6-9,250,1964,1,26,26,1
Jeff Sanders,1990,1993,6-8,225,1966,4,24,27,1
Randy White,1990,1994,6-8,240,1967,5,23,27,1
Ed Horton,1990,1990,6-8,230,1967,1,23,23,1
Jay Taylor,1990,1990,6-3,190,1967,1,23,23,1
Pervis Ellison,1990,2001,6-9,210,1967,12,23,34,0
Leonard Taylor,1990,1990,6-8,220,1966,1,24,24,1
Bob McCann,1990,1998,6-6,244,1964,9,26,34,0
Kenny Payne,1990,1993,6-8,195,1966,4,24,27,1
Doug West,1990,2001,6-6,200,1967,12,23,34,0
Delaney Rudd,1990,1993,6-2,180,1962,4,28,31,1
Haywoode Workman,1990,2000,6-2,180,1966,11,24,34,0
Byron Irvin,1990,1993,6-5,190,1966,4,24,27,1
Donald Royal,1990,1998,6-8,210,1966,9,24,32,0
B.J. Armstrong,1990,2000,6-2,175,1967,11,23,33,0
Todd Lichti,1990,1994,6-4,205,1967,5,23,27,1
Doug Roth,1990,1990,6-11,255,1967,1,23,23,1
Jaren Jackson,1990,2002,6-4,190,1967,13,23,35,0
Kenny Battle,1990,1993,6-6,210,1964,4,26,29,1
Stanley Brundy,1990,1990,6-6,210,1967,1,23,23,1
Jerrod Mustaf,1991,1994,6-10,238,1969,4,22,25,1
Scott Williams,1991,2005,6-10,230,1968,15,23,37,0
Dee Brown,1991,2002,6-1,160,1968,12,23,34,0
Mahmoud Abdul-Rauf,1991,2001,6-1,162,1969,11,22,32,0
Tony Massenburg,1991,2005,6-9,220,1967,15,24,38,0
Lance Blanks,1991,1993,6-4,190,1966,3,25,27,1
Terry Mills,1991,2001,6-10,230,1967,11,24,34,0
Alan Ogg,1991,1993,7-2,240,1967,3,24,26,1
Brian Oliver,1991,1998,6-4,210,1968,8,23,30,0
Anthony Bonner,1991,1996,6-8,215,1968,6,23,28,1
Travis Mays,1991,1993,6-2,190,1968,3,23,25,1
Kenny Williams,1991,1994,6-9,205,1969,4,22,25,1
Matt Bullard,1991,2002,6-10,215,1967,12,24,35,0
Dan O'Sullivan,1991,1996,6-10,250,1968,6,23,28,1
Jud Buechler,1991,2002,6-6,220,1968,12,23,34,0
Chris Munk,1991,1991,6-9,225,1967,1,24,24,1
Kennard Winchester,1991,1993,6-5,210,1966,3,25,27,1
Trevor Wilson,1991,1996,6-7,210,1968,6,23,28,1
Jayson Williams,1991,1999,6-9,240,1968,9,23,31,0
Howard Wright,1991,1993,6-8,220,1967,3,24,26,1
A.J. Wynder,1991,1991,6-2,180,1964,1,27,27,1
Alaa Abdelnaby,1991,1995,6-10,240,1968,5,23,27,1
Les Jepsen,1991,1992,7-0,237,1967,2,24,25,1
Duane Causwell,1991,2001,7-0,240,1968,11,23,33,0
Cedric Ceballos,1991,2001,6-6,190,1969,11,22,32,0
Loy Vaught,1991,2001,6-9,230,1968,11,23,33,0
Steve Scheffler,1991,1997,6-9,250,1967,7,24,30,0
Ian Lockhart,1991,1991,6-8,240,1967,1,24,24,1
Alec Kessler,1991,1994,6-11,230,1967,4,24,27,1
Kevin Pritchard,1991,1996,6-3,180,1967,6,24,29,1
Gary Payton,1991,2007,6-4,180,1968,17,23,39,0
Greg Foster,1991,2003,6-11,240,1968,13,23,35,0
Tony Smith,1991,2001,6-3,185,1968,11,23,33,0
Marcus Liberty,1991,1994,6-8,205,1968,4,23,26,1
Gerald Glass,1991,1996,6-5,221,1967,6,24,29,1
Richard Coffey,1991,1991,6-6,212,1965,1,26,26,1
Kendall Gill,1991,2005,6-5,195,1968,15,23,37,0
Tate George,1991,1995,6-5,190,1968,5,23,27,1
Derrick Coleman,1991,2005,6-10,230,1967,15,24,38,0
Bimbo Coles,1991,2004,6-1,180,1968,14,23,36,0
Bo Kimble,1991,1993,6-4,190,1966,3,25,27,1
Kurk Lee,1991,1991,6-3,190,1967,1,24,24,1
Felton Spencer,1991,2002,7-0,265,1968,12,23,34,0
Dennis Scott,1991,2000,6-8,229,1968,10,23,32,0
Stojko Vrankovic,1991,1999,7-2,260,1964,9,27,35,0
Milos Babic,1991,1992,7-0,240,1968,2,23,24,1
Anthony Cook,1991,1996,6-9,205,1967,6,24,29,1
Tyrone Hill,1991,2004,6-9,240,1968,14,23,36,0
Steve Henson,1991,1999,5-11,177,1968,9,23,31,0
Negele Knight,1991,1999,6-1,175,1967,9,24,32,0
Sean Higgins,1991,1998,6-9,205,1968,8,23,30,0
Dwayne Schintzius,1991,1999,7-1,260,1968,9,23,31,0
Dan Godfread,1991,1992,6-10,250,1967,2,24,25,1
Tony Dawson,1991,1995,6-7,215,1967,5,24,28,1
Danny Ferry,1991,2003,6-10,230,1966,13,25,37,0
Elden Campbell,1991,2005,6-11,215,1968,15,23,37,0
A.J. English,1991,1992,6-3,175,1967,2,24,25,1
Keith Askins,1991,1999,6-7,197,1967,9,24,32,0
Gerald Paddio,1991,1994,6-7,205,1965,4,26,29,1
Dave Jamerson,1991,1994,6-5,190,1967,4,24,27,1
Lionel Simmons,1991,1997,6-7,210,1968,7,23,29,0
Andy Toolson,1991,1996,6-6,210,1966,6,25,30,1
Willie Burton,1991,1999,6-8,210,1968,9,23,31,0
Rick Calloway,1991,1991,6-6,180,1966,1,25,25,1
Walter Palmer,1991,1993,7-1,215,1968,3,23,25,1
Irving Thomas,1991,1991,6-8,225,1966,1,25,25,1
Jim Grandholm,1991,1991,7-0,235,1960,1,31,31,1
Cedric Ball,1991,1991,6-8,210,1968,1,23,23,1
Tony Harris,1991,1995,6-3,190,1967,5,24,28,1
Mario Elie,1991,2001,6-5,210,1963,11,28,38,0
Rumeal Robinson,1991,1997,6-2,195,1966,7,25,31,0
Larry Robinson,1991,2002,6-3,180,1968,12,23,34,0
Henry James,1991,1998,6-8,220,1965,8,26,33,0
Terrell Brandon,1992,2002,5-11,180,1970,11,22,32,0
Brian Howard,1992,1993,6-6,204,1967,2,25,26,1
Greg Anthony,1992,2002,6-0,176,1967,11,25,35,0
Patrick Eddie,1992,1992,6-11,240,1967,1,25,25,1
Corey Crowder,1992,1995,6-5,214,1969,4,23,26,1
Larry Stewart,1992,1997,6-8,220,1968,6,24,29,1
Stanley Roberts,1992,2000,7-0,285,1970,9,22,30,0
Rick Fox,1992,2004,6-7,230,1969,13,23,35,0
Derek Strong,1992,2001,6-8,220,1968,10,24,33,0
Lamont Strothers,1992,1993,6-4,190,1968,2,24,25,1
Donald Hodge,1992,1996,7-0,230,1969,5,23,27,1
Cedric Hunter,1992,1992,6-0,180,1965,1,27,27,1
Bison Dele,1992,1999,6-9,235,1969,8,23,30,0
Mark Randall,1992,1995,6-8,235,1967,4,25,28,1
Carl Thomas,1992,1998,6-4,175,1969,7,23,29,0
Charles Thomas,1992,1992,6-3,175,1969,1,23,23,1
John Turner,1992,1992,6-8,245,1967,1,25,25,1
Rich King,1992,1995,7-2,260,1969,4,23,26,1
Greg Sutton,1992,1996,6-2,170,1967,5,25,29,1
Joao Vianna,1992,1992,6-9,215,1966,1,26,26,1
Stephen Thompson,1992,1992,6-4,185,1968,1,24,24,1
LeRon Ellis,1992,1996,6-9,225,1969,5,23,27,1
Kevin Brooks,1992,1994,6-6,200,1969,3,23,25,1
Larry Johnson,1992,2001,6-6,250,1969,10,23,32,0
Steve Bardo,1992,1996,6-5,190,1968,5,24,28,1
Mike Iuzzolino,1992,1993,5-10,175,1968,2,24,25,1
Dikembe Mutombo,1992,2009,7-2,245,1966,18,26,43,0
Dale Davis,1992,2007,6-11,230,1969,16,23,38,0
Stacey Augmon,1992,2006,6-8,205,1968,15,24,38,0
Rodney Monroe,1992,1992,6-3,185,1968,1,24,24,1
Pete Chilcutt,1992,2000,6-10,230,1968,9,24,32,0
Victor Alexander,1992,2002,6-9,265,1969,11,23,33,0
Luc Longley,1992,2001,7-2,265,1969,10,23,32,0
Kenny Anderson,1992,2005,6-0,168,1970,14,22,35,0
Tharon Mayes,1992,1992,6-3,175,1968,1,24,24,1
LaBradford Smith,1992,1994,6-3,200,1969,3,23,25,1
Kevin Lynch,1992,1993,6-5,195,1968,2,24,25,1
Paul Graham,1992,1994,6-6,200,1967,3,25,27,1
Tracy Moore,1992,1997,6-4,200,1965,6,27,32,1
Mark Macon,1992,1999,6-5,185,1969,8,23,30,0
Doug Smith,1992,1996,6-10,220,1969,5,23,27,1
David Benoit,1992,2001,6-8,220,1968,10,24,33,0
Demetrius Calip,1992,1992,6-1,165,1969,1,23,23,1
Robert Pack,1992,2004,6-2,180,1969,13,23,35,0
Keith Owens,1992,1992,6-7,225,1969,1,23,23,1
Billy Owens,1992,2001,6-8,220,1969,10,23,32,0
Sean Green,1992,1994,6-5,210,1970,3,22,24,1
Jimmy Oliver,1992,1999,6-5,205,1969,8,23,30,0
Eric Murdock,1992,2000,6-1,190,1968,9,24,32,0
Steve Smith,1992,2005,6-7,200,1969,14,23,36,0
Carl Herrera,1992,1999,6-9,215,1966,8,26,33,0
Chris Gatling,1992,2002,6-10,220,1967,11,25,35,0
Chris Corchiani,1992,1994,6-0,185,1968,3,24,26,1
Isaac Austin,1992,2002,6-10,255,1969,11,23,33,0
Bobby Phills,1992,2000,6-5,210,1969,9,23,31,0
Doug Lee,1992,1995,6-5,200,1964,4,28,31,1
Marty Conlon,1992,2000,6-10,224,1968,9,24,32,0
Myron Brown,1992,1992,6-3,180,1969,1,23,23,1
Tom Copa,1992,1992,6-10,275,1964,1,28,28,1
Elliot Perry,1992,2002,6-0,150,1969,11,23,33,0
Randy Brown,1992,2003,6-2,190,1968,12,24,35,0
Malik Sealy,1993,2000,6-8,190,1970,8,23,30,0
Ricky Blanton,1993,1993,6-7,215,1966,1,27,27,1
Chris Smith,1993,1995,6-3,190,1970,3,23,25,1
LaPhonso Ellis,1993,2003,6-8,240,1970,11,23,33,0
Harold Miner,1993,1996,6-5,210,1971,4,22,25,1
Alonzo Mourning,1993,2008,6-10,240,1970,16,23,38,0
Isaiah Morris,1993,1993,6-8,229,1969,1,24,24,1
Litterial Green,1993,1999,6-1,185,1970,7,23,29,0
Melvin Newbern,1993,1993,6-4,200,1967,1,26,26,1
Tony Bennett,1993,1995,6-0,175,1969,3,24,26,1
Jay Guidinger,1993,1994,6-10,255,1969,2,24,25,1
Tom Gugliotta,1993,2005,6-10,240,1969,13,24,36,0
Alex Blackwell,1993,1993,6-6,250,1970,1,23,23,1
Jim Jackson,1993,2006,6-6,220,1970,14,23,36,0
Tracy Murray,1993,2004,6-7,225,1971,12,22,33,0
Jo Jo English,1993,1995,6-4,195,1970,3,23,25,1
Matt Geiger,1993,2002,7-0,243,1969,10,24,33,0
Andre Spencer,1993,1994,6-6,210,1964,2,29,30,1
Robert Horry,1993,2008,6-9,220,1970,16,23,38,0
Elmore Spencer,1993,1997,7-0,270,1969,5,24,28,1
Oliver Miller,1993,2004,6-9,280,1970,12,23,34,0
Byron Houston,1993,1996,6-5,250,1969,4,24,27,1
Bryant Stith,1993,2002,6-5,208,1970,10,23,32,0
Barry Stevens,1993,1993,6-5,195,1963,1,30,30,1
Walter Bond,1993,1995,6-5,200,1969,3,24,26,1
Reggie Smith,1993,1994,6-10,240,1970,2,23,24,1
Randy Woods,1993,1996,5-10,185,1970,4,23,26,1
Latrell Sprewell,1993,2005,6-5,190,1970,13,23,35,0
Sean Rooks,1993,2004,6-10,250,1969,12,24,35,0
Keith Jennings,1993,1995,5-7,160,1968,3,25,27,1
Stephen Howard,1993,1998,6-9,225,1970,6,23,28,1
Jon Barry,1993,2006,6-4,195,1969,14,24,37,0
Corey Williams,1993,1994,6-2,190,1970,2,23,24,1
Anthony Peeler,1993,2005,6-4,208,1969,13,24,36,0
Anthony Pullard,1993,1993,6-10,245,1966,1,27,27,1
Hubert Davis,1993,2004,6-5,183,1970,12,23,34,0
Thomas Jordan,1993,1993,6-10,220,1968,1,25,25,1
Lorenzo Williams,1993,2000,6-9,200,1969,8,24,31,0
Gundars Vetra,1993,1993,6-6,195,1967,1,26,26,1
Robert Werdann,1993,1997,6-11,250,1970,5,23,27,1
Lee Mayberry,1993,1999,6-1,172,1970,7,23,29,0
Anthony Avent,1993,2000,6-9,235,1969,8,24,31,0
Marcus Webb,1993,1993,6-9,255,1970,1,23,23,1
Sam Mack,1993,2002,6-7,220,1970,10,23,32,0
Clarence Weatherspoon,1993,2005,6-6,240,1970,13,23,35,0
Shaquille O'Neal,1993,2011,7-1,325,1972,19,21,39,0
Don MacLean,1993,2001,6-10,235,1970,9,23,31,0
Marlon Maxey,1993,1994,6-8,250,1969,2,24,25,1
Doug Christie,1993,2007,6-6,200,1970,15,23,37,0
Richard Dumas,1993,1996,6-7,200,1969,4,24,27,1
Todd Day,1993,2001,6-6,188,1970,9,23,31,0
Matt Othick,1993,1993,6-2,165,1969,1,24,24,1
Eric Anderson,1993,1994,6-9,220,1970,2,23,24,1
John Crotty,1993,2003,6-1,185,1969,11,24,34,0
Radisav Curcic,1993,1993,6-10,275,1965,1,28,28,1
Christian Laettner,1993,2005,6-11,235,1969,13,24,36,0
Doug Overton,1993,2004,6-3,190,1969,12,24,35,0
Pat Durham,1993,1995,6-7,210,1967,3,26,28,1
Walt Williams,1993,2003,6-8,219,1970,11,23,33,0
Duane Cooper,1993,1994,6-1,185,1969,2,24,25,1
Lloyd Daniels,1993,1998,6-7,205,1967,6,26,31,1
Dave Johnson,1993,1994,6-7,210,1970,2,23,24,1
Dexter Cambridge,1993,1993,6-7,224,1970,1,23,23,1
Brent Price,1993,2002,6-1,165,1968,10,25,34,0
Adam Keefe,1993,2001,6-9,230,1970,9,23,31,0
Joe Courtney,1993,1997,6-8,235,1969,5,24,28,1
Mike Peplowski,1994,1996,6-10,270,1970,3,24,26,1
Chris Jent,1994,1997,6-7,220,1970,4,24,27,1
Andrew Gaze,1994,1999,6-7,205,1965,6,29,34,1
Richard Petruska,1994,1994,6-10,260,1969,1,25,25,1
Skeeter Henry,1994,1994,6-7,190,1967,1,27,27,1
Chad Gallagher,1994,1994,6-10,255,1969,1,25,25,1
Chris Webber,1994,2008,6-9,245,1973,15,21,35,0
P.J. Brown,1994,2008,6-11,225,1969,15,25,39,0
David Wesley,1994,2007,6-0,190,1970,14,24,37,0
Matt Wenstrom,1994,1994,7-1,250,1970,1,24,24,1
Andres Guibert,1994,1995,6-10,225,1968,2,26,27,1
Evers Burns,1994,1994,6-8,260,1971,1,23,23,1
Scott Burrell,1994,2001,6-7,218,1971,8,23,30,0
Bo Outlaw,1994,2008,6-8,210,1971,15,23,37,0
Jamal Mashburn,1994,2004,6-8,240,1972,11,22,32,0
Mitchell Butler,1994,2004,6-5,210,1970,11,24,34,0
Aaron Williams,1994,2008,6-9,220,1971,15,23,37,0
Darren Morningstar,1994,1994,6-10,235,1969,1,25,25,1
Gerald Madkins,1994,1998,6-4,200,1969,5,25,29,1
Geert Hammink,1994,1996,7-0,262,1969,3,25,27,1
Josh Grant,1994,1994,6-9,223,1967,1,27,27,1
Malcolm Mackey,1994,1994,6-9,248,1970,1,24,24,1
Anfernee Hardaway,1994,2008,6-7,195,1971,15,23,37,0
Greg Graham,1994,1998,6-4,174,1970,5,24,28,1
Ricky Grace,1994,1994,6-1,180,1967,1,27,27,1
George Lynch,1994,2005,6-8,218,1970,12,24,35,0
Lucious Harris,1994,2005,6-5,190,1970,12,24,35,0
Gary Alexander,1994,1994,6-7,240,1969,1,25,25,1
Chris Whitney,1994,2004,6-0,168,1971,11,23,33,0
Sam Cassell,1994,2008,6-3,185,1969,15,25,39,0
Calbert Cheaney,1994,2006,6-7,209,1971,13,23,35,0
Gheorghe Muresan,1994,2000,7-7,303,1971,7,23,29,0
Antonio Harvey,1994,2003,6-11,225,1970,10,24,33,0
Scott Haskin,1994,1994,6-11,250,1970,1,24,24,1
Luther Wright,1994,1994,7-2,270,1971,1,23,23,1
Toni Kukoc,1994,2006,6-10,192,1968,13,26,38,0
Darnell Mee,1994,1995,6-5,175,1971,2,23,24,1
Nick Van Exel,1994,2006,6-1,170,1971,13,23,35,0
Dell Demps,1994,1997,6-3,205,1970,4,24,27,1
Lindsey Hunter,1994,2010,6-2,170,1970,17,24,40,0
Bobby Hurley,1994,1998,6-0,165,1971,5,23,27,1
Adonis Jordan,1994,1999,5-11,170,1970,6,24,29,1
Popeye Jones,1994,2004,6-8,250,1970,11,24,34,0
Kevin Thompson,1994,1994,6-11,260,1971,1,23,23,1
Rodney Rogers,1994,2005,6-7,235,1971,12,23,34,0
Keith Tower,1994,1997,6-11,250,1970,4,24,27,1
Dino Radja,1994,1997,6-11,225,1967,4,27,30,1
Stanley Jackson,1994,1994,6-3,185,1970,1,24,24,1
Acie Earl,1994,1997,6-10,240,1970,4,24,27,1
Ervin Johnson,1994,2006,6-11,245,1967,13,27,39,0
Isaiah Rider,1994,2002,6-5,215,1971,9,23,31,0
Vin Baker,1994,2006,6-11,232,1971,13,23,35,0
James Robinson,1994,2001,6-2,180,1970,8,24,31,0
Bob Martin,1994,1995,7-0,250,1969,2,25,26,1
Eric Riley,1994,1999,7-0,245,1970,6,24,29,1
Shawn Bradley,1994,2005,7-6,235,1972,12,22,33,0
Doug Edwards,1994,1996,6-7,220,1971,3,23,25,1
Harold Ellis,1994,1998,6-5,200,1970,5,24,28,1
Terry Dehere,1994,1999,6-2,190,1971,6,23,28,1
Reggie Jordan,1994,2000,6-4,195,1968,7,26,32,0
Allan Houston,1994,2005,6-6,200,1971,12,23,34,0
Rex Walters,1994,2000,6-4,190,1970,7,24,30,0
Michael Curry,1994,2005,6-5,210,1968,12,26,37,0
Chris Mills,1994,2003,6-6,215,1970,10,24,33,0
Antonio Davis,1994,2006,6-9,215,1968,13,26,38,0
Corie Blount,1994,2004,6-9,240,1969,11,25,35,0
Bryon Russell,1994,2006,6-7,225,1970,13,24,36,0
Brian Davis,1994,1994,6-7,200,1970,1,24,24,1
Bill Edwards,1994,1994,6-8,215,1971,1,23,23,1
Chris King,1994,1999,6-8,215,1969,6,25,30,1
Alphonso Ford,1994,1995,6-1,190,1971,2,23,24,1
Warren Kidd,1994,1994,6-9,235,1970,1,24,24,1
Derrick Phelps,1995,1995,6-4,181,1972,1,23,23,1
Clifford Rozier,1995,1998,6-11,245,1972,4,23,26,1
Eric Piatkowski,1995,2008,6-7,215,1970,14,25,38,0
Ivano Newbill,1995,1998,6-9,245,1970,4,25,28,1
Monty Williams,1995,2003,6-8,225,1971,9,24,32,0
Glenn Robinson,1995,2005,6-7,225,1973,11,22,32,0
Julius Nwosu,1995,1995,6-10,255,1971,1,24,24,1
Reggie Slater,1995,2003,6-7,215,1970,9,25,33,0
Dontonio Wingfield,1995,1998,6-8,256,1974,4,21,24,1
Sharone Wright,1995,1998,6-11,260,1973,4,22,25,1
Dwayne Morton,1995,1995,6-7,195,1971,1,24,24,1
Zan Tabak,1995,2001,7-0,245,1970,7,25,31,0
Trevor Ruffin,1995,1996,6-1,185,1970,2,25,26,1
Dickey Simpkins,1995,2002,6-9,248,1972,8,23,30,0
Mark Strickland,1995,2003,6-9,210,1970,9,25,33,0
Aaron Swinson,1995,1995,6-5,230,1971,1,24,24,1
Lamond Murray,1995,2006,6-7,236,1973,12,22,33,0
Carlos Rogers,1995,2002,6-11,220,1971,8,24,31,0
Fred Vinson,1995,2000,6-4,190,1971,6,24,29,1
Eldridge Recasner,1995,2002,6-3,190,1967,8,28,35,0
Anthony Tucker,1995,1995,6-8,220,1969,1,26,26,1
Wesley Person,1995,2005,6-6,195,1971,11,24,34,0
Jamie Watson,1995,1999,6-7,190,1972,5,23,27,1
Michael Smith,1995,2001,6-8,230,1972,7,23,29,0
B.J. Tyler,1995,1995,6-1,185,1971,1,24,24,1
Jalen Rose,1995,2007,6-8,210,1973,13,22,34,0
Brooks Thompson,1995,1998,6-4,193,1970,4,25,28,1
Derrick Alston,1995,1997,6-11,225,1972,3,23,25,1
Charlie Ward,1995,2005,6-2,190,1970,11,25,35,0
Khalid Reeves,1995,2000,6-3,199,1972,6,23,28,1
Elmer Bennett,1995,1997,6-0,170,1970,3,25,27,1
Darrin Hancock,1995,1997,6-7,205,1971,3,24,26,1
Tom Hovasse,1995,1995,6-8,205,1967,1,28,28,1
Ryan Lorthridge,1995,1995,6-4,190,1972,1,23,23,1
Matt Fish,1995,1997,6-11,235,1969,3,26,28,1
Darrell Armstrong,1995,2008,6-0,170,1968,14,27,40,0
Eric Mobley,1995,1997,6-11,235,1970,3,25,27,1
Tim Breaux,1995,1998,6-7,215,1970,4,25,28,1
Jerome Harmon,1995,1995,6-4,190,1969,1,26,26,1
Bill Curley,1995,2001,6-9,220,1972,7,23,29,0
Brian Grant,1995,2006,6-9,254,1972,12,23,34,0
Askia Jones,1995,1995,6-5,200,1971,1,24,24,1
Antonio Lang,1995,2000,6-8,205,1972,6,23,28,1
Eddie Jones,1995,2008,6-6,190,1971,14,24,37,0
Howard Eisley,1995,2006,6-2,177,1972,12,23,34,0
Yinka Dare,1995,1998,7-0,265,1972,4,23,26,1
Tony Dumas,1995,1998,6-6,190,1972,4,23,26,1
Anthony Miller,1995,2005,6-9,225,1971,11,24,34,0
Jason Kidd,1995,2013,6-4,205,1973,19,22,40,0
Sergei Bazarevich,1995,1995,6-2,168,1965,1,30,30,1
Greg Minor,1995,1999,6-6,210,1971,5,24,28,1
Eric Montross,1995,2002,7-0,270,1971,8,24,31,0
Grant Hill,1995,2013,6-8,225,1972,19,23,41,0
Donyell Marshall,1995,2009,6-9,218,1973,15,22,36,0
Chris Childs,1995,2003,6-3,195,1967,9,28,36,0
Juwan Howard,1995,2013,6-9,240,1973,19,22,40,0
James Blackwell,1995,1995,6-0,190,1968,1,27,27,1
Darrick Martin,1995,2008,5-11,170,1971,14,24,37,0
Jim McIlvaine,1995,2001,7-1,240,1972,7,23,29,0
Aaron McKie,1995,2007,6-5,209,1972,13,23,35,0
Jerome Allen,1996,1997,6-4,184,1973,2,23,24,1
Chris Carr,1996,2001,6-5,207,1974,6,22,27,1
Cuonzo Martin,1996,1997,6-5,213,1971,2,25,26,1
Corey Beck,1996,1999,6-1,190,1971,4,25,28,1
Sasha Danilovic,1996,1997,6-5,200,1970,2,26,27,1
Jason Caffey,1996,2003,6-8,255,1973,8,23,30,0
Cherokee Parks,1996,2004,6-11,235,1972,9,24,32,0
Mark Davis,1996,2000,6-7,210,1973,5,23,27,1
Junior Burrough,1996,1996,6-8,242,1973,1,23,23,1
Antonio McDyess,1996,2011,6-9,220,1974,16,22,37,0
Donnie Boyce,1996,1997,6-5,196,1973,2,23,24,1
Eric Williams,1996,2007,6-8,220,1972,12,24,35,0
Ed O'Bannon,1996,1997,6-8,222,1972,2,24,25,1
David Vaughn,1996,1999,6-9,240,1973,4,23,26,1
Logan Vander Velden,1996,1996,6-8,215,1971,1,25,25,1
Howard Nathan,1996,1996,5-11,175,1972,1,24,24,1
Rastko Cvetkovic,1996,1996,7-1,260,1970,1,26,26,1
Anthony Goldwire,1996,2006,6-1,182,1971,11,25,35,0
Rasheed Wallace,1996,2013,6-10,225,1974,18,22,39,0
Marques Bragg,1996,1996,6-8,230,1970,1,26,26,1
Randolph Childress,1996,1997,6-2,188,1972,2,24,25,1
Robert Churchwell,1996,1996,6-6,195,1972,1,24,24,1
Charles Claxton,1996,1996,7-0,265,1970,1,26,26,1
Corliss Williamson,1996,2007,6-7,245,1973,12,23,34,0
Jeff Webster,1996,1996,6-8,232,1971,1,25,25,1
Rich Manning,1996,1997,6-11,253,1970,2,26,27,1
Cory Alexander,1996,2005,6-1,185,1973,10,23,32,0
Alvin Heggs,1996,1996,6-8,225,1967,1,29,29,1
Andrew DeClercq,1996,2005,6-10,230,1973,10,23,32,0
Joe Smith,1996,2011,6-10,225,1975,16,21,36,0
Dwayne Whitfield,1996,1996,6-9,240,1972,1,24,24,1
Alan Henderson,1996,2007,6-9,235,1972,12,24,35,0
Donny Marshall,1996,2003,6-7,230,1972,8,24,31,0
Martin Lewis,1996,1997,6-5,210,1975,2,21,22,1
Cedric Lewis,1996,1996,6-10,235,1969,1,27,27,1
Loren Meyer,1996,1999,6-10,257,1972,4,24,27,1
Voshon Lenard,1996,2006,6-4,205,1973,11,23,33,0
Greg Ostertag,1996,2006,7-2,280,1973,11,23,33,0
John Coker,1996,2001,7-0,253,1971,6,25,30,1
Clint McDaniel,1996,1996,6-4,180,1972,1,24,24,1
Arvydas Sabonis,1996,2003,7-3,279,1964,8,32,39,0
Stefano Rusconi,1996,1996,6-9,240,1968,1,28,28,1
Don Reid,1996,2003,6-8,250,1973,8,23,30,0
Kurt Thomas,1996,2013,6-9,230,1972,18,24,41,0
Terrence Rencher,1996,1996,6-3,185,1973,1,23,23,1
Thomas Hamilton,1996,2000,7-2,330,1975,5,21,25,1
Shawn Respert,1996,1999,6-1,195,1972,4,24,27,1
Kevin Garnett,1996,2016,6-11,240,1976,21,20,40,0
Darryl Johnson,1996,1996,6-1,170,1965,1,31,31,1
Melvin Booker,1996,1997,6-1,185,1972,2,24,25,1
Lou Roe,1996,1997,6-7,220,1972,2,24,25,1
John Amaechi,1996,2003,6-10,270,1970,8,26,33,0
Jerry Stackhouse,1996,2013,6-6,218,1974,18,22,39,0
Michael Finley,1996,2010,6-7,215,1973,15,23,37,0
Eric Snow,1996,2008,6-3,190,1973,13,23,35,0
Brent Barry,1996,2009,6-6,185,1971,14,25,38,0
Ashraf Amaya,1996,1997,6-8,230,1971,2,25,26,1
Larry Sykes,1996,1996,6-9,255,1973,1,23,23,1
Bob Sura,1996,2005,6-5,200,1973,10,23,32,0
Sherell Ford,1996,1996,6-7,210,1972,1,24,24,1
Vincenzo Esposito,1996,1996,6-3,198,1969,1,27,27,1
Todd Mundt,1996,1996,7-0,250,1970,1,26,26,1
Gary Trent,1996,2004,6-8,250,1974,9,22,30,0
Travis Best,1996,2005,5-11,182,1972,10,24,33,0
Bryant Reeves,1996,2001,7-0,275,1973,6,23,28,1
Damon Stoudamire,1996,2008,5-10,171,1973,13,23,35,0
Jimmy King,1996,1997,6-5,210,1973,2,23,24,1
Theo Ratliff,1996,2011,6-10,225,1973,16,23,38,0
Lawrence Moten,1996,1998,6-5,185,1972,3,24,26,1
Mario Bennett,1996,2000,6-6,235,1973,5,23,27,1
Frankie King,1996,1997,6-1,185,1972,2,24,25,1
George Zidek,1996,1998,7-0,250,1973,3,23,25,1
Tyus Edney,1996,2001,5-10,152,1973,6,23,28,1
Fred Hoiberg,1996,2005,6-4,203,1972,10,24,33,0
Malik Rose,1997,2009,6-7,250,1974,13,23,35,0
Todd Fuller,1997,2001,6-11,255,1974,5,23,27,1
Donald Whiteside,1997,1998,5-10,160,1969,2,28,29,1
Matt Maloney,1997,2003,6-3,192,1971,7,26,32,1
Amal McCaskill,1997,2004,6-11,235,1973,8,24,31,0
Shandon Anderson,1997,2006,6-6,208,1973,10,24,33,0
Ray Owes,1997,1997,6-9,224,1972,1,25,25,1
Jermaine O'Neal,1997,2014,6-11,226,1978,18,19,36,0
Jimmy Carruth,1997,1997,6-10,265,1969,1,28,28,1
Stephon Marbury,1997,2009,6-2,180,1977,13,20,32,0
Evric Gray,1997,1997,6-7,235,1969,1,28,28,1
Roy Rogers,1997,2000,6-10,235,1973,4,24,27,1
Marcus Camby,1997,2013,6-11,220,1974,17,23,39,0
Joe Stephens,1997,2000,6-7,210,1973,4,24,27,1
Michael Hawkins,1997,2001,6-0,178,1972,5,25,29,1
Devin Gray,1997,2000,6-7,240,1972,4,25,28,1
Allen Iverson,1997,2010,6-0,165,1975,14,22,35,0
Walter McCarty,1997,2006,6-10,230,1974,10,23,32,0
Erick Strickland,1997,2005,6-3,210,1973,9,24,32,0
Vitaly Potapenko,1997,2007,6-10,280,1975,11,22,32,0
Matt Steigenga,1997,1997,6-7,225,1970,1,27,27,1
Kerry Kittles,1997,2005,6-5,179,1974,9,23,31,0
Tony Delk,1997,2006,6-1,189,1974,10,23,32,0
Travis Knight,1997,2003,7-0,235,1974,7,23,29,1
Ray Allen,1997,2014,6-5,205,1975,18,22,39,0
Aleksandar Djordjevic,1997,1997,6-2,198,1967,1,30,30,1
Kobe Bryant,1997,2016,6-6,212,1978,20,19,38,0
Nate Driggers,1997,1997,6-5,215,1973,1,24,24,1
Emanual Davis,1997,2003,6-4,195,1968,7,29,35,1
Ben Davis,1997,2000,6-9,240,1972,4,25,28,1
Jason Sasser,1997,1999,6-7,225,1974,3,23,25,1
Reggie Geary,1997,1998,6-2,187,1973,2,24,25,1
Erick Dampier,1997,2012,6-11,265,1975,16,22,37,0
Priest Lauderdale,1997,1998,7-4,325,1973,2,24,25,1
Mark Hendrickson,1997,2000,6-9,220,1974,4,23,26,1
Chris Robinson,1997,1998,6-5,200,1974,2,23,24,1
Antoine Walker,1997,2008,6-8,224,1976,12,21,32,0
Brian Evans,1997,1999,6-8,220,1973,3,24,26,1
Ben Wallace,1997,2012,6-9,240,1974,16,23,38,0
Brent Scott,1997,1997,6-10,250,1971,1,26,26,1
Dean Garrett,1997,2002,6-10,225,1966,6,31,36,1
Randy Livingston,1997,2007,6-4,209,1975,11,22,32,0
Jamie Feick,1997,2001,6-9,255,1974,5,23,27,1
James Scott,1997,1997,6-6,180,1972,1,25,25,1
Horacio Llamas Grey,1997,1998,6-11,285,1973,2,24,25,1
Kevin Salvadori,1997,1998,7-0,231,1970,2,27,28,1
Derek Fisher,1997,2014,6-1,200,1974,18,23,40,0
Shawnelle Scott,1997,2002,6-10,250,1972,6,25,30,1
Brett Szabo,1997,1997,6-11,230,1968,1,29,29,1
Shareef Abdur-Rahim,1997,2008,6-9,225,1976,12,21,32,0
Shane Heal,1997,2004,6-0,180,1970,8,27,34,0
Samaki Walker,1997,2006,6-9,240,1976,10,21,30,0
Stevin Smith,1997,1997,6-2,208,1972,1,25,25,1
John Wallace,1997,2004,6-8,225,1974,8,23,30,0
Steve Hamer,1997,1997,7-0,245,1973,1,24,24,1
Gaylon Nickerson,1997,1997,6-3,190,1969,1,28,28,1
Othella Harrington,1997,2008,6-9,235,1974,12,23,34,0
Martin Muursepp,1997,1998,6-9,235,1974,2,23,24,1
Mark Bradtke,1997,1997,6-10,265,1968,1,29,29,1
Ruben Nembhard,1997,1997,6-3,208,1972,1,25,25,1
Darvin Ham,1997,2005,6-7,220,1973,9,24,32,0
Jeff McInnis,1997,2008,6-4,190,1974,12,23,34,0
Lorenzen Wright,1997,2009,6-11,225,1975,13,22,34,0
Marcus Brown,1997,2000,6-3,185,1974,4,23,26,1
Steve Nash,1997,2014,6-3,195,1974,18,23,40,0
Dexter Boney,1997,1997,6-4,185,1970,1,27,27,1
Bruce Bowen,1997,2009,6-7,185,1971,13,26,38,0
Jerome Williams,1997,2005,6-9,206,1973,9,24,32,0
Moochie Norris,1997,2006,6-1,175,1973,10,24,33,0
Antonio Daniels,1998,2011,6-4,195,1975,14,23,36,0
Drew Barry,1998,2000,6-5,191,1973,3,25,27,1
Bobby Jackson,1998,2009,6-1,185,1973,12,25,36,0
Dontae' Jones,1998,1998,6-8,220,1975,1,23,23,1
Ron Mercer,1998,2005,6-7,210,1976,8,22,29,0
Austin Croshere,1998,2009,6-9,235,1975,12,23,34,0
Kebu Stewart,1998,1998,6-8,239,1973,1,25,25,1
Kelvin Cato,1998,2007,6-11,255,1974,10,24,33,0
Chris Garner,1998,2001,5-10,156,1975,4,23,26,1
William Cunningham,1998,1999,6-11,250,1974,2,24,25,1
Jeff Nordgaard,1998,1998,6-7,225,1973,1,25,25,1
Rodrick Rhodes,1998,2000,6-6,225,1973,3,25,27,1
Rusty LaRue,1998,2004,6-2,210,1973,7,25,31,1
Derek Anderson,1998,2008,6-5,194,1974,11,24,34,0
Anthony Johnson,1998,2010,6-3,190,1974,13,24,36,0
Adonal Foyle,1998,2009,6-10,250,1975,12,23,34,0
Jerald Honeycutt,1998,1999,6-9,245,1974,2,24,25,1
Jason Lawson,1998,1998,6-11,240,1974,1,24,24,1
Tracy McGrady,1998,2012,6-8,210,1979,15,19,33,0
Chris Crawford,1998,2004,6-9,235,1975,7,23,29,1
Tony Farmer,1998,2000,6-9,244,1970,3,28,30,1
Keith Closs,1998,2000,7-3,212,1976,3,22,24,1
Bubba Wells,1998,1998,6-5,230,1974,1,24,24,1
Chris Anstey,1998,2000,7-0,249,1975,3,23,25,1
Kiwane Garris,1998,2000,6-2,183,1974,3,24,26,1
Michael Stewart,1998,2005,6-10,230,1975,8,23,30,0
Chauncey Billups,1998,2014,6-3,202,1976,17,22,38,0
Danny Fortson,1998,2007,6-7,260,1976,10,22,31,0
James Cotton,1998,1999,6-5,220,1975,2,23,24,1
Travis Williams,1998,1999,6-6,215,1969,2,29,30,1
Johnny Taylor,1998,2000,6-9,220,1974,3,24,26,1
Rick Brunson,1998,2006,6-4,190,1972,9,26,34,0
Shea Seals,1998,1998,6-5,210,1975,1,23,23,1
Anthony Parker,1998,2012,6-6,215,1975,15,23,37,0
Eric Washington,1998,1999,6-4,190,1974,2,24,25,1
DeJuan Wheat,1998,1999,6-0,165,1973,2,25,26,1
Cedric Henderson,1998,2002,6-7,215,1975,5,23,27,1
James Collins,1998,1998,6-4,196,1973,1,25,25,1
Tim Thomas,1998,2010,6-10,230,1977,13,21,33,0
Troy Hudson,1998,2008,6-1,170,1976,11,22,32,0
Michael McDonald,1998,1998,6-10,232,1969,1,29,29,1
Tim Duncan,1998,2016,6-11,250,1976,19,22,40,0
Kevin Ollie,1998,2010,6-4,195,1972,13,26,38,0
Alvin Williams,1998,2007,6-5,185,1974,10,24,33,0
Tony Battie,1998,2012,6-11,230,1976,15,22,36,0
John Thomas,1998,2006,6-9,265,1975,9,23,31,0
Jacque Vaughn,1998,2009,6-1,190,1975,12,23,34,0
Mark Pope,1998,2005,6-10,235,1972,8,26,33,0
Charles O'Bannon,1998,1999,6-5,209,1975,2,23,24,1
Scot Pollard,1998,2008,6-11,265,1975,11,23,33,0
Brandon Williams,1998,2003,6-6,215,1975,6,23,28,1
Ed Stokes,1998,1998,7-0,264,1971,1,27,27,1
Tariq Abdul-Wahad,1998,2003,6-6,223,1974,6,24,29,1
Keith Booth,1998,1999,6-6,226,1974,2,24,25,1
Brevin Knight,1998,2009,5-10,173,1975,12,23,34,0
Derek Grimm,1998,1998,6-9,230,1974,1,24,24,1
Zydrunas Ilgauskas,1998,2011,7-3,238,1975,14,23,36,0
Reggie Hanson,1998,1998,6-8,195,1968,1,30,30,1
Maurice Taylor,1998,2007,6-9,260,1976,10,22,31,0
God Shammgod,1998,1998,6-0,169,1976,1,22,22,1
Charles Smith,1998,2006,6-4,194,1975,9,23,31,0
Keith Van Horn,1998,2006,6-10,220,1975,9,23,31,0
Marko Milic,1998,1999,6-6,235,1977,2,21,22,1
Lawrence Funderburke,1998,2005,6-9,230,1970,8,28,35,0
Etdrick Bohannon,1998,2001,6-9,220,1973,4,25,28,1
Ed Gray,1998,1999,6-3,210,1975,2,23,24,1
Jonathan Kerner,1999,1999,6-11,245,1974,1,25,25,1
Rashard Lewis,1999,2014,6-10,215,1979,16,20,35,0
Kornel David,1999,2001,6-9,235,1971,3,28,30,1
Michael Dickerson,1999,2003,6-5,190,1975,5,24,28,1
Mikki Moore,1999,2012,6-11,225,1975,14,24,37,0
Felipe Lopez,1999,2002,6-5,199,1974,4,25,28,1
LaMark Baker,1999,1999,6-1,175,1969,1,30,30,1
Damon Jones,1999,2009,6-3,185,1976,11,23,33,0
Gerard King,1999,2001,6-9,230,1972,3,27,29,1
Michael Doleac,1999,2008,6-11,262,1977,10,22,31,0
Bryce Drew,1999,2004,6-2,185,1974,6,25,30,1
Korleone Young,1999,1999,6-7,213,1978,1,21,21,1
Brad Miller,1999,2012,6-11,244,1976,14,23,36,0
Alvin Sims,1999,1999,6-4,235,1974,1,25,25,1
Nazr Mohammed,1999,2016,6-10,221,1977,18,22,39,0
Ruben Patterson,1999,2008,6-5,224,1975,10,24,33,0
Earl Boykins,1999,2012,5-5,135,1976,14,23,36,0
Raef LaFrentz,1999,2008,6-11,240,1976,10,23,32,0
Paul Pierce,1999,2017,6-7,235,1977,19,22,40,0
Antawn Jamison,1999,2014,6-8,223,1976,16,23,38,0
Makhtar N'Diaye,1999,1999,6-8,245,1973,1,26,26,1
Vladimir Stepania,1999,2004,7-0,236,1976,6,23,28,1
Trevor Winter,1999,1999,7-0,275,1974,1,25,25,1
Ricky Davis,1999,2010,6-6,195,1979,12,20,31,0
Al Harrington,1999,2014,6-9,230,1980,16,19,34,0
Jerome James,1999,2009,7-0,300,1975,11,24,34,0
Ryan Stack,1999,2000,6-11,215,1975,2,24,25,1
Robert Traylor,1999,2005,6-8,284,1977,7,22,28,1
Toby Bailey,1999,2000,6-6,213,1975,2,24,25,1
Jeffrey Sheppard,1999,1999,6-3,190,1974,1,25,25,1
Tyrone Nesby,1999,2002,6-6,225,1976,4,23,26,1
Rasho Nesterovic,1999,2010,7-0,248,1976,12,23,34,0
J.R. Henderson,1999,1999,6-8,226,1976,1,23,23,1
Sam Jacobson,1999,2001,6-4,215,1975,3,24,26,1
Matt Harpring,1999,2009,6-7,231,1976,11,23,33,0
Bruno Sundov,1999,2005,7-2,220,1980,7,19,25,1
Miles Simon,1999,1999,6-3,202,1975,1,24,24,1
Randell Jackson,1999,2000,6-11,215,1976,2,23,24,1
Sean Marks,1999,2011,6-10,250,1975,13,24,36,0
Kelly McCarty,1999,1999,6-7,200,1975,1,24,24,1
Tyson Wheeler,1999,1999,5-10,165,1975,1,24,24,1
Gerald Brown,1999,1999,6-4,210,1975,1,24,24,1
Jahidi White,1999,2005,6-9,290,1976,7,23,29,1
Pat Garrity,1999,2008,6-9,238,1976,10,23,32,0
Peja Stojakovic,1999,2011,6-9,220,1977,13,22,34,0
Charles Jones,1999,2000,6-3,180,1975,2,24,25,1
Cory Carr,1999,1999,6-3,210,1975,1,24,24,1
Mike Bibby,1999,2012,6-1,190,1978,14,21,34,0
Brian Skinner,1999,2012,6-9,255,1976,14,23,36,0
Paul Grant,1999,2004,7-0,245,1974,6,25,30,1
Cuttino Mobley,1999,2009,6-4,190,1975,11,24,34,0
Shammond Williams,1999,2007,6-1,201,1975,9,24,32,0
Corey Benjamin,1999,2003,6-6,200,1978,5,21,25,1
Peter Aluma,1999,1999,6-10,260,1973,1,26,26,1
Jelani McCoy,1999,2008,6-10,245,1977,10,22,31,0
Vince Carter,1999,2018,6-6,220,1977,20,22,41,0
Larry Hughes,1999,2012,6-5,184,1979,14,20,33,0
Andrae Patterson,1999,2000,6-9,238,1975,2,24,25,1
Michael Olowokandi,1999,2007,7-0,269,1975,9,24,32,0
Dirk Nowitzki,1999,2018,7-0,245,1978,20,21,40,0
Bonzi Wells,1999,2008,6-5,210,1976,10,23,32,0
Casey Shaw,1999,1999,6-11,260,1975,1,24,24,1
Tyronn Lue,1999,2009,6-0,175,1977,11,22,32,0
Keon Clark,1999,2004,6-11,220,1975,6,24,29,1
Roshown McLeod,1999,2001,6-8,221,1975,3,24,26,1
Marlon Garnett,1999,1999,6-2,186,1975,1,24,24,1
Jason Williams,1999,2011,6-1,190,1975,13,24,36,0
Ira Bowman,2000,2002,6-5,195,1973,3,27,29,1
Dion Glover,2000,2005,6-5,228,1978,6,22,27,1
Wally Szczerbiak,2000,2009,6-7,244,1977,10,23,32,0
Jason Terry,2000,2018,6-2,185,1977,19,23,41,0
Anthony Carter,2000,2012,6-1,190,1975,13,25,37,0
Jumaine Jones,2000,2007,6-8,218,1979,8,21,28,0
Trajan Langdon,2000,2002,6-3,197,1976,3,24,26,1
Michael Ruffin,2000,2009,6-9,246,1977,10,23,32,0
Shawn Marion,2000,2015,6-7,220,1978,16,22,37,0
Cal Bowdler,2000,2002,6-10,245,1977,3,23,25,1
Calvin Booth,2000,2009,6-11,230,1976,10,24,33,0
Tim James,2000,2002,6-7,212,1976,3,24,26,1
Mirsad Turkcan,2000,2000,6-9,236,1976,1,24,24,1
Harold Jamison,2000,2002,6-8,260,1976,3,24,26,1
Rick Hughes,2000,2000,6-9,235,1973,1,27,27,1
Andre Miller,2000,2016,6-3,200,1976,17,24,40,0
Jonathan Bender,2000,2010,6-11,202,1981,11,19,29,0
Chris Herren,2000,2001,6-2,197,1975,2,25,26,1
Ryan Robertson,2000,2000,6-5,190,1976,1,24,24,1
James Posey,2000,2011,6-8,215,1977,12,23,34,0
Derek Hood,2000,2000,6-8,222,1976,1,24,24,1
Kenny Thomas,2000,2010,6-7,261,1977,11,23,33,0
Jamel Thomas,2000,2001,6-6,215,1973,2,27,28,1
William Avery,2000,2002,6-2,197,1979,3,21,23,1
Baron Davis,2000,2012,6-3,209,1979,13,21,33,0
Metta World Peace,2000,2017,6-6,260,1979,18,21,38,0
Derrick Dial,2000,2004,6-4,184,1975,5,25,29,1
Devean George,2000,2010,6-8,220,1977,11,23,33,0
Eddie Robinson,2000,2004,6-8,210,1976,5,24,28,1
Steve Francis,2000,2008,6-3,195,1977,9,23,31,0
Rafer Alston,2000,2010,6-2,171,1976,11,24,34,0
Rodney Buford,2000,2005,6-5,189,1977,6,23,28,1
Wayne Turner,2000,2000,6-2,190,1976,1,24,24,1
A.J. Bramlett,2000,2000,6-10,227,1977,1,23,23,1
Elton Brand,2000,2016,6-8,275,1979,17,21,37,0
Quincy Lewis,2000,2004,6-7,215,1977,5,23,27,1
Greg Buckner,2000,2009,6-4,210,1976,10,24,33,0
Tim Young,2000,2000,7-0,220,1976,1,24,24,1
Jeff Foster,2000,2012,6-11,236,1977,13,23,35,0
Lazaro Borrell,2000,2000,6-8,220,1972,1,28,28,1
Laron Profit,2000,2006,6-5,204,1977,7,23,29,1
Aleksandar Radojevic,2000,2005,7-3,250,1976,6,24,29,1
Lari Ketner,2000,2001,6-9,277,1977,2,23,24,1
Todd MacCulloch,2000,2003,7-0,280,1976,4,24,27,1
Adrian Griffin,2000,2008,6-5,217,1974,9,26,34,0
Jermaine Jackson,2000,2006,6-4,204,1976,7,24,30,1
Dedric Willoughby,2000,2000,6-3,180,1974,1,26,26,1
Evan Eschmeyer,2000,2003,6-11,255,1975,4,25,28,1
Chucky Atkins,2000,2010,5-11,160,1974,11,26,36,0
Ryan Bowen,2000,2010,6-7,215,1975,11,25,35,0
Scott Padgett,2000,2007,6-9,240,1976,8,24,31,0
DeMarco Johnson,2000,2000,6-9,245,1975,1,25,25,1
Lamar Odom,2000,2013,6-10,220,1979,14,21,34,0
Vonteego Cummings,2000,2002,6-3,185,1976,3,24,26,1
Richard Hamilton,2000,2013,6-6,185,1978,14,22,35,0
Corey Maggette,2000,2013,6-6,218,1979,14,21,34,0
Jason Miskiri,2000,2000,6-2,175,1975,1,25,25,1
Milt Palacio,2000,2006,6-3,195,1978,7,22,28,1
Obinna Ekezie,2000,2005,6-9,270,1975,6,25,30,1
John Celestand,2000,2000,6-4,178,1977,1,23,23,1
Dalibor Bagaric,2001,2003,7-1,255,1980,3,21,23,1
Zendon Hamilton,2001,2006,6-11,250,1975,6,26,31,1
Courtney Alexander,2001,2003,6-5,205,1977,3,24,26,1
Jason Hart,2001,2010,6-3,185,1978,10,23,32,0
Joel Przybilla,2001,2013,7-1,255,1979,13,22,34,0
Hedo Turkoglu,2001,2015,6-10,220,1979,15,22,36,0
Keyon Dooling,2001,2013,6-3,196,1980,13,21,33,0
Dan McClintock,2001,2001,7-0,270,1977,1,24,24,1
Donnell Harvey,2001,2005,6-8,220,1980,5,21,25,1
Jerome Moiso,2001,2005,6-10,235,1978,5,23,27,1
Lavor Postell,2001,2003,6-5,215,1978,3,23,25,1
Terrance Roberson,2001,2001,6-7,215,1976,1,25,25,1
Mike Miller,2001,2017,6-8,218,1980,17,21,37,0
Garth Joseph,2001,2001,7-2,315,1973,1,28,28,1
DeShawn Stevenson,2001,2013,6-5,210,1981,13,20,32,0
Eddie Gill,2001,2009,6-0,190,1978,9,23,31,0
Eddie House,2001,2011,6-1,180,1978,11,23,33,0
Mark Blount,2001,2009,7-0,230,1975,9,26,34,0
Jake Tsakalidis,2001,2007,7-2,285,1979,7,22,28,1
Eduardo Najera,2001,2012,6-8,240,1976,12,25,36,0
Ruben Garces,2001,2001,6-9,245,1973,1,28,28,1
Lee Nailon,2001,2006,6-9,238,1975,6,26,31,1
Mateen Cleaves,2001,2006,6-2,205,1977,6,24,29,1
Chris Porter,2001,2001,6-7,218,1978,1,23,23,1
Ruben Wolkowyski,2001,2003,6-10,270,1973,3,28,30,1
Jamaal Magloire,2001,2012,6-11,259,1978,12,23,34,0
Quentin Richardson,2001,2013,6-6,223,1980,13,21,33,0
Daniel Santiago,2001,2005,7-1,256,1976,5,25,29,1
Stephen Jackson,2001,2014,6-8,218,1978,14,23,36,0
Mark Madsen,2001,2009,6-9,240,1976,9,25,33,0
Jamal Crawford,2001,2018,6-5,200,1980,18,21,38,0
Mike Penberthy,2001,2002,6-3,185,1974,2,27,28,1
Andy Panko,2001,2001,6-9,222,1977,1,24,24,1
Jabari Smith,2001,2005,6-11,250,1977,5,24,28,1
Ira Newble,2001,2008,6-7,220,1975,8,26,33,0
Sean Colson,2001,2001,6-0,175,1975,1,26,26,1
DerMarr Johnson,2001,2008,6-9,201,1980,8,21,28,0
Stanislav Medvedenko,2001,2007,6-10,250,1979,7,22,28,1
Michael Redd,2001,2012,6-6,220,1979,12,22,33,0
Art Long,2001,2003,6-9,250,1972,3,29,31,1
Jason Collier,2001,2005,7-0,260,1977,5,24,28,1
Marc Jackson,2001,2007,6-10,270,1975,7,26,32,1
Paul McPherson,2001,2001,6-4,210,1978,1,23,23,1
Khalid El-Amin,2001,2001,5-10,200,1979,1,22,22,1
Olumide Oyedeji,2001,2003,6-10,240,1981,3,20,22,1
Morris Peterson,2001,2011,6-7,218,1977,11,24,34,0
Chris Mihm,2001,2009,7-0,265,1979,9,22,30,0
David Vanterpool,2001,2001,6-5,200,1973,1,28,28,1
Desmond Mason,2001,2010,6-7,224,1977,10,24,33,0
Mamadou N'Diaye,2001,2005,7-0,255,1975,5,26,30,1
Kenyon Martin,2001,2015,6-9,234,1977,15,24,38,0
Brian Cardinal,2001,2012,6-8,245,1977,12,24,35,0
Stromile Swift,2001,2009,6-9,225,1979,9,22,30,0
Marcus Fizer,2001,2006,6-9,262,1978,6,23,28,1
Steve Goodrich,2001,2002,6-10,220,1976,2,25,26,1
A.J. Guyton,2001,2003,6-1,180,1978,3,23,25,1
Pepe Sanchez,2001,2003,6-4,195,1977,3,24,26,1
Jake Voskuhl,2001,2009,6-11,245,1977,9,24,32,0
Soumaila Samake,2001,2003,7-0,230,1978,3,23,25,1
Raja Bell,2001,2012,6-5,204,1976,12,25,36,0
Erick Barkley,2001,2002,6-1,177,1978,2,23,24,1
Mike Smith,2001,2001,6-8,195,1976,1,25,25,1
Jamal Robinson,2001,2001,6-7,212,1973,1,28,28,1
Darius Miles,2001,2009,6-9,210,1981,9,20,28,0
Dan Langhi,2001,2004,6-11,220,1977,4,24,27,1
Hanno Mottola,2001,2002,6-11,247,1976,2,25,26,1
Wang Zhizhi,2001,2005,7-0,255,1977,5,24,28,1
Dragan Tarlac,2001,2001,6-10,260,1973,1,28,28,1
Oscar Torres,2002,2003,6-6,210,1976,2,26,27,1
Maurice Evans,2002,2012,6-5,220,1978,11,24,34,0
Shane Battier,2002,2014,6-8,220,1978,13,24,36,0
Kenny Satterfield,2002,2003,6-2,186,1981,2,21,22,1
Zach Randolph,2002,2018,6-9,260,1981,17,21,37,0
Jason Richardson,2002,2015,6-6,220,1981,14,21,34,0
Jamaal Tinsley,2002,2014,6-3,195,1978,13,24,36,0
Jeryl Sasser,2002,2003,6-6,200,1979,2,23,24,1
Troy Murphy,2002,2013,6-11,245,1980,12,22,33,0
Alvin Jones,2002,2002,6-11,265,1978,1,24,24,1
Loren Woods,2002,2008,7-1,245,1978,7,24,30,1
Zeljko Rebraca,2002,2006,7-0,257,1972,5,30,34,1
Norm Richardson,2002,2002,6-5,190,1979,1,23,23,1
Pau Gasol,2002,2018,7-0,250,1980,17,22,38,0
Joe Johnson,2002,2018,6-7,240,1981,17,21,37,0
Samuel Dalembert,2002,2015,6-11,255,1981,14,21,34,0
Etan Thomas,2002,2011,6-9,256,1978,10,24,33,0
Chris Andersen,2002,2017,6-10,245,1978,16,24,39,0
Predrag Drobnjak,2002,2005,6-11,270,1975,4,27,30,1
Earl Watson,2002,2014,6-1,195,1979,13,23,35,0
Jason Collins,2002,2014,7-0,255,1978,13,24,36,0
Jarron Collins,2002,2011,6-11,255,1978,10,24,33,0
Primoz Brezec,2002,2010,7-2,252,1979,9,23,31,0
Damone Brown,2002,2005,6-9,200,1979,4,23,26,1
Speedy Claxton,2002,2009,5-11,166,1978,8,24,31,0
Joseph Forte,2002,2003,6-4,194,1981,2,21,22,1
Tony Parker,2002,2018,6-2,185,1982,17,20,36,0
Brendan Haywood,2002,2015,7-0,268,1979,14,23,36,0
Antonis Fotsis,2002,2002,6-10,219,1981,1,21,21,1
Tyson Chandler,2002,2018,7-1,240,1982,17,20,36,0
Tremaine Fowlkes,2002,2005,6-8,220,1976,4,26,29,1
Rodney White,2002,2005,6-9,238,1980,4,22,25,1
Ernest Brown,2002,2002,7-0,244,1979,1,23,23,1
Kedrick Brown,2002,2005,6-7,222,1981,4,21,24,1
Kwame Brown,2002,2013,6-11,270,1982,12,20,31,0
Dean Oliver,2002,2003,5-11,180,1978,2,24,25,1
Kirk Haston,2002,2003,6-9,242,1979,2,23,24,1
Carlos Arroyo,2002,2011,6-2,202,1979,10,23,32,0
Trenton Hassell,2002,2010,6-5,200,1979,9,23,31,0
Eddie Griffin,2002,2007,6-10,220,1982,6,20,25,1
Ansu Sesay,2002,2005,6-9,225,1976,4,26,29,1
Tierre Brown,2002,2005,6-2,189,1979,4,23,26,1
Charlie Bell,2002,2011,6-3,200,1979,10,23,32,0
Steven Hunter,2002,2010,7-0,220,1981,9,21,29,0
Terence Morris,2002,2006,6-9,221,1979,5,23,27,1
Joe Crispin,2002,2002,6-0,185,1979,1,23,23,1
Brandon Armstrong,2002,2004,6-5,188,1980,3,22,24,1
Jamison Brewer,2002,2005,6-4,184,1980,4,22,25,1
Richard Jefferson,2002,2018,6-7,233,1980,17,22,38,0
Tang Hamilton,2002,2002,6-8,220,1978,1,24,24,1
Gerald Wallace,2002,2015,6-7,215,1982,14,20,33,0
Malik Allen,2002,2011,6-10,255,1978,10,24,33,0
Bobby Simmons,2002,2012,6-7,210,1980,11,22,32,0
Ruben Boumtje-Boumtje,2002,2004,7-0,257,1978,3,24,26,1
Gilbert Arenas,2002,2012,6-3,191,1982,11,20,30,0
Brian Scalabrine,2002,2012,6-9,241,1978,11,24,34,0
Andrei Kirilenko,2002,2015,6-9,220,1981,14,21,34,0
Mengke Bateer,2002,2004,6-11,290,1975,3,27,29,1
Ratko Varda,2002,2002,7-1,260,1979,1,23,23,1
Leon Smith,2002,2004,6-10,235,1980,3,22,24,1
Will Solomon,2002,2009,6-1,185,1978,8,24,31,0
Mike James,2002,2014,6-2,188,1975,13,27,39,0
Michael Bradley,2002,2006,6-10,245,1979,5,23,27,1
Isaac Fontaine,2002,2002,6-4,210,1975,1,27,27,1
Eddy Curry,2002,2013,7-0,295,1982,12,20,31,0
Vladimir Radmanovic,2002,2013,6-10,227,1980,12,22,33,0
Alton Ford,2002,2004,6-9,275,1981,3,21,23,1
Jeff Trepagnier,2002,2004,6-4,200,1979,3,23,25,1
DeSagana Diop,2002,2013,7-0,300,1982,12,20,31,0
Jamal Sampson,2003,2007,6-11,235,1983,5,20,24,1
Guy Rucker,2003,2003,6-11,265,1977,1,26,26,1
Ryan Humphrey,2003,2005,6-8,235,1979,3,24,26,1
Dan Gadzuric,2003,2012,6-11,240,1978,10,25,34,0
Antoine Rigaudeau,2003,2003,6-7,210,1971,1,32,32,1
Casey Jacobsen,2003,2008,6-6,215,1981,6,22,27,1
Amar'e Stoudemire,2003,2016,6-10,245,1982,14,21,34,0
John Salmons,2003,2015,6-7,210,1979,13,24,36,0
Nate Huffman,2003,2003,7-1,245,1975,1,28,28,1
Robert Archibald,2003,2004,6-11,250,1980,2,23,24,1
Maceo Baston,2003,2009,6-9,215,1975,7,28,34,1
Mike Batiste,2003,2003,6-8,225,1977,1,26,26,1
Chris Jefferies,2003,2004,6-8,225,1980,2,23,24,1
Marko Jaric,2003,2009,6-7,198,1978,7,25,31,1
Kareem Rush,2003,2010,6-6,215,1980,8,23,30,0
Vincent Yarbrough,2003,2003,6-7,210,1981,1,22,22,1
Jared Jeffries,2003,2013,6-11,230,1981,11,22,32,0
Tamar Slay,2003,2005,6-8,215,1980,3,23,25,1
Manu Ginobili,2003,2018,6-6,205,1977,16,26,41,0
Sean Lampley,2003,2004,6-7,227,1979,2,24,25,1
Dajuan Wagner,2003,2007,6-2,200,1983,5,20,24,1
Cezary Trybanski,2003,2004,7-2,240,1979,2,24,25,1
Nikoloz Tskitishvili,2003,2006,7-0,225,1983,4,20,23,1
Predrag Savovic,2003,2003,6-6,225,1976,1,27,27,1
Juaquin Hawkins,2003,2003,6-7,220,1973,1,30,30,1
Chris Wilcox,2003,2013,6-10,221,1982,11,21,31,0
Ken Johnson,2003,2003,6-11,240,1978,1,25,25,1
J.R. Bremer,2003,2004,6-2,185,1980,2,23,24,1
Tayshaun Prince,2003,2016,6-9,212,1980,14,23,36,0
Marcus Haislip,2003,2010,6-10,230,1980,8,23,30,0
Juan Dixon,2003,2009,6-3,164,1978,7,25,31,1
Chris Owens,2003,2003,6-7,245,1979,1,24,24,1
Adam Harrington,2003,2003,6-5,200,1980,1,23,23,1
Dan Dickau,2003,2008,6-0,190,1978,6,25,30,1
Devin Brown,2003,2010,6-5,220,1978,8,25,32,0
Gordan Giricek,2003,2008,6-6,210,1977,6,26,31,1
Nene Hilario,2003,2018,6-11,250,1982,16,21,36,0
Tito Maddox,2003,2003,6-4,190,1981,1,22,22,1
Jannero Pargo,2003,2015,6-1,175,1979,13,24,36,0
Smush Parker,2003,2008,6-4,190,1981,6,22,27,1
Drew Gooden,2003,2016,6-10,250,1981,14,22,35,0
Bostjan Nachbar,2003,2008,6-9,221,1980,6,23,28,1
Roger Mason,2003,2014,6-5,200,1980,12,23,34,0
Jiri Welsch,2003,2006,6-7,208,1980,4,23,26,1
Fred Jones,2003,2009,6-4,210,1979,7,24,30,1
Jay Williams,2003,2003,6-2,195,1981,1,22,22,1
Melvin Ely,2003,2014,6-10,260,1978,12,25,36,0
Pat Burke,2003,2007,6-11,250,1973,5,30,34,1
Yao Ming,2003,2011,7-6,310,1980,9,23,31,0
Mike Wilks,2003,2010,5-10,185,1979,8,24,31,0
Qyntel Woods,2003,2006,6-8,221,1981,4,22,25,1
Lonny Baxter,2003,2006,6-8,260,1979,4,24,27,1
Frank Williams,2003,2005,6-3,212,1980,3,23,25,1
Reggie Evans,2003,2015,6-8,245,1980,13,23,35,0
Caron Butler,2003,2016,6-7,228,1980,14,23,36,0
Rasual Butler,2003,2016,6-7,215,1979,14,24,37,0
Mike Dunleavy,2003,2017,6-9,230,1980,15,23,37,0
Carlos Boozer,2003,2015,6-9,258,1981,13,22,34,0
Ronald Murray,2003,2010,6-4,190,1979,8,24,31,0
Igor Rakocevic,2003,2003,6-3,183,1978,1,25,25,1
Mehmet Okur,2003,2012,6-11,249,1979,10,24,33,0
Efthimi Rentzias,2003,2003,6-11,250,1976,1,27,27,1
Junior Harrington,2003,2007,6-4,180,1980,5,23,27,1
Paul Shirley,2003,2005,6-10,230,1977,3,26,28,1
Raul Lopez,2004,2005,6-1,170,1980,2,24,25,1
Omar Cook,2004,2005,6-1,190,1982,2,22,23,1
Sasha Pavlovic,2004,2013,6-8,220,1983,10,21,30,0
Luke Walton,2004,2013,6-8,235,1980,10,24,33,0
Kirk Penney,2004,2005,6-5,220,1980,2,24,25,1
Desmond Penigar,2004,2004,6-7,245,1981,1,23,23,1
Troy Bell,2004,2004,6-1,180,1980,1,24,24,1
T.J. Ford,2004,2012,6-0,165,1983,9,21,29,0
Brian Cook,2004,2012,6-9,234,1980,9,24,32,0
Richie Frahm,2004,2008,6-5,210,1977,5,27,31,1
Keith McLeod,2004,2007,6-2,188,1979,4,25,28,1
Hiram Fuller,2004,2004,6-9,240,1981,1,23,23,1
Marcus Banks,2004,2011,6-2,200,1981,8,23,30,0
Willie Green,2004,2015,6-4,200,1981,12,23,34,0
Udonis Haslem,2004,2018,6-8,235,1980,15,24,38,0
Zarko Cabarkapa,2004,2006,6-11,235,1981,3,23,25,1
Ben Handlogten,2004,2005,6-10,240,1973,2,31,32,1
David West,2004,2018,6-9,250,1980,15,24,38,0
Mo Williams,2004,2016,6-1,198,1982,13,22,34,0
Kendrick Perkins,2004,2016,6-10,270,1984,13,20,32,0
Travis Outlaw,2004,2014,6-9,210,1984,11,20,30,0
Maurice Carter,2004,2004,6-5,210,1976,1,28,28,1
Reece Gaines,2004,2006,6-6,205,1981,3,23,25,1
Zaza Pachulia,2004,2018,6-11,270,1984,15,20,34,0
Jarvis Hayes,2004,2010,6-7,220,1981,7,23,29,1
Matt Carroll,2004,2013,6-6,212,1980,10,24,33,0
Torraye Braggs,2004,2005,6-8,245,1976,2,28,29,1
Linton Johnson,2004,2009,6-8,205,1980,6,24,29,1
Jerome Beasley,2004,2004,6-10,237,1980,1,24,24,1
Kaniel Dickens,2004,2008,6-8,215,1978,5,26,30,1
Travis Hansen,2004,2004,6-6,205,1978,1,26,26,1
Chris Bosh,2004,2016,6-11,235,1984,13,20,32,0
Curtis Borchardt,2004,2005,7-0,240,1980,2,24,25,1
Alex Garcia,2004,2005,6-3,220,1980,2,24,25,1
Kirk Hinrich,2004,2016,6-4,190,1981,13,23,35,0
Jason Kapono,2004,2012,6-8,213,1981,9,23,31,0
Desmond Ferguson,2004,2004,6-7,203,1977,1,27,27,1
Chris Kaman,2004,2016,7-0,265,1982,13,22,34,0
Britton Johnsen,2004,2005,6-10,210,1979,2,25,26,1
Darius Songaila,2004,2011,6-9,248,1978,8,26,33,0
Leandro Barbosa,2004,2017,6-3,194,1982,14,22,35,0
Ronald Dupree,2004,2011,6-7,209,1981,8,23,30,0
Keith Bogans,2004,2014,6-5,215,1980,11,24,34,0
Luke Ridnour,2004,2015,6-2,175,1981,12,23,34,0
Ndudi Ebi,2004,2005,6-9,200,1984,2,20,21,1
James Jones,2004,2017,6-8,218,1980,14,24,37,0
Francisco Elson,2004,2012,7-0,235,1976,9,28,36,0
Dahntay Jones,2004,2017,6-6,225,1980,14,24,37,0
Ime Udoka,2004,2011,6-6,215,1977,8,27,34,0
Boris Diaw,2004,2017,6-8,250,1982,14,22,35,0
Carmelo Anthony,2004,2018,6-8,240,1984,15,20,34,0
Kyle Korver,2004,2018,6-7,212,1981,15,23,37,0
Steve Blake,2004,2016,6-3,172,1980,13,24,36,0
LeBron James,2004,2018,6-8,250,1984,15,20,34,0
Matt Barnes,2004,2017,6-7,226,1980,14,24,37,0
Marquis Daniels,2004,2013,6-6,200,1981,10,23,32,0
Maciej Lampe,2004,2006,6-11,275,1985,3,19,21,1
Mike Sweetney,2004,2007,6-8,275,1982,4,22,25,1
Dwyane Wade,2004,2018,6-4,220,1982,15,22,36,0
Slavko Vranes,2004,2004,7-5,275,1983,1,21,21,1
Josh Howard,2004,2013,6-7,210,1980,10,24,33,0
Mickael Pietrus,2004,2013,6-6,215,1982,10,22,31,0
Brandon Hunter,2004,2005,6-7,260,1980,2,24,25,1
Zoran Planinic,2004,2006,6-7,195,1982,3,22,24,1
Theron Smith,2004,2005,6-8,225,1980,2,24,25,1
Darko Milicic,2004,2013,7-0,250,1985,10,19,28,0
Josh Davis,2004,2012,6-8,235,1980,9,24,32,0
Josh Smith,2005,2018,6-9,225,1985,14,20,33,0
J.R. Smith,2005,2018,6-6,225,1985,14,20,33,0
Pape Sow,2005,2007,6-10,250,1981,3,24,26,1
Kris Humphries,2005,2017,6-9,235,1985,13,20,32,0
Ben Gordon,2005,2015,6-3,200,1983,11,22,32,0
Donta Smith,2005,2006,6-7,215,1983,2,22,23,1
Ha Seung-Jin,2005,2006,7-3,305,1985,2,20,21,1
Kirk Snyder,2005,2008,6-6,225,1983,4,22,25,1
Dwight Howard,2005,2018,6-11,265,1985,14,20,33,0
Andre Barrett,2005,2008,5-10,172,1982,4,23,26,1
Tony Allen,2005,2018,6-4,213,1982,14,23,36,0
Devin Harris,2005,2018,6-3,192,1983,14,22,35,0
David Harrison,2005,2008,7-0,280,1982,4,23,26,1
Shaun Livingston,2005,2018,6-7,192,1985,14,20,33,0
Matt Freije,2005,2007,6-10,240,1981,3,24,26,1
Sebastian Telfair,2005,2015,6-0,165,1985,11,20,30,0
Anderson Varejao,2005,2017,6-10,273,1982,13,23,35,0
Antonio Burks,2005,2006,6-1,200,1980,2,25,26,1
Delonte West,2005,2012,6-4,180,1983,8,22,29,0
Billy Thomas,2005,2008,6-4,208,1975,4,30,33,1
James Thomas,2005,2006,6-8,235,1980,2,25,26,1
Carlos Delfino,2005,2013,6-6,230,1982,9,23,31,0
Jared Reiner,2005,2007,6-11,255,1982,3,23,25,1
Brandin Knight,2005,2005,6-0,180,1981,1,24,24,1
Justin Reed,2005,2007,6-8,240,1982,3,23,25,1
Luol Deng,2005,2018,6-9,220,1985,14,20,33,0
Andre Emmett,2005,2012,6-5,230,1982,8,23,30,0
Damien Wilkins,2005,2018,6-6,225,1980,14,25,38,0
Jackie Butler,2005,2007,6-10,250,1985,3,20,22,1
Josh Childress,2005,2014,6-8,210,1983,10,22,31,0
Lionel Chalmers,2005,2005,6-0,180,1980,1,25,25,1
Emeka Okafor,2005,2013,6-10,252,1982,9,23,31,0
Mark Jones,2005,2005,6-6,215,1975,1,30,30,1
John Edwards,2005,2006,7-0,275,1981,2,24,25,1
Corsley Edwards,2005,2005,6-9,275,1979,1,26,26,1
Viktor Khryapa,2005,2008,6-9,210,1982,4,23,26,1
Maurice Baker,2005,2005,6-1,175,1979,1,26,26,1
Peter John Ramos,2005,2005,7-3,275,1985,1,20,20,1
Chris Duhon,2005,2013,6-1,185,1982,9,23,31,0
Mario Kasun,2005,2006,7-1,260,1980,2,25,26,1
Kevin Martin,2005,2016,6-7,199,1983,12,22,33,0
Beno Udrih,2005,2017,6-3,205,1982,13,23,35,0
Andres Nocioni,2005,2012,6-7,225,1979,8,26,33,0
Geno Carlisle,2005,2005,6-3,180,1976,1,29,29,1
Robert Swift,2005,2009,7-0,245,1985,5,20,24,1
Awvee Storey,2005,2008,6-6,222,1977,4,28,31,1
Rafael Araujo,2005,2007,6-11,280,1980,3,25,27,1
Royal Ivey,2005,2014,6-3,200,1981,10,24,33,0
Sasha Vujacic,2005,2017,6-7,195,1984,13,21,33,0
Dorell Wright,2005,2015,6-9,205,1985,11,20,30,0
Luke Jackson,2005,2008,6-7,215,1981,4,24,27,1
Jackson Vroman,2005,2006,6-10,220,1981,2,24,25,1
Luis Flores,2005,2005,6-2,200,1981,1,24,24,1
Jameer Nelson,2005,2018,6-0,190,1982,14,23,36,0
Andris Biedrins,2005,2014,6-11,240,1986,10,19,28,0
Tony Bobbitt,2005,2005,6-4,190,1979,1,26,26,1
Ibo Kutluay,2005,2005,6-6,200,1974,1,31,31,1
Quinton Ross,2005,2011,6-6,195,1981,7,24,30,1
Bernard Robinson,2005,2007,6-6,210,1980,3,25,27,1
Al Jefferson,2005,2018,6-10,289,1985,14,20,33,0
Didier Ilunga-Mbenga,2005,2011,7-0,245,1980,7,25,31,1
Matt Bonner,2005,2016,6-10,235,1980,12,25,36,0
Nenad Krstic,2005,2011,7-0,240,1983,7,22,28,1
Nick Collison,2005,2018,6-10,255,1980,14,25,38,0
Erik Daniels,2005,2005,6-8,214,1982,1,23,23,1
Horace Jenkins,2005,2005,6-1,180,1974,1,31,31,1
Yuta Tabuse,2005,2005,5-9,165,1980,1,25,25,1
Trevor Ariza,2005,2018,6-8,215,1985,14,20,33,0
Andre Iguodala,2005,2018,6-6,215,1984,14,21,34,0
Pavel Podkolzin,2005,2006,7-5,260,1985,2,20,21,1
Matt Walsh,2006,2006,6-6,205,1982,1,24,24,1
Andre Owens,2006,2008,6-4,200,1980,3,26,28,1
Chris Paul,2006,2018,6-0,175,1985,13,21,33,0
Robert Whaley,2006,2006,6-10,260,1982,1,24,24,1
Arvydas Macijauskas,2006,2006,6-4,214,1980,1,26,26,1
Danny Granger,2006,2015,6-9,222,1983,10,23,32,0
Hakim Warrick,2006,2013,6-9,219,1982,8,24,31,0
Luther Head,2006,2011,6-3,185,1982,6,24,29,1
Martell Webster,2006,2015,6-7,230,1986,10,20,29,0
Chuck Hayes,2006,2016,6-6,240,1983,11,23,33,0
John Lucas III,2006,2017,5-11,166,1982,12,24,35,0
Fabricio Oberto,2006,2011,6-10,245,1975,6,31,36,1
Jose Calderon,2006,2018,6-3,200,1981,13,25,37,0
Derrick Zimmerman,2006,2006,6-3,195,1981,1,25,25,1
Wayne Simien,2006,2007,6-9,255,1983,2,23,24,1
Andray Blatche,2006,2014,6-11,235,1986,9,20,28,0
Sergei Monia,2006,2006,6-8,220,1983,1,23,23,1
Bracey Wright,2006,2007,6-3,210,1984,2,22,23,1
Antoine Wright,2006,2011,6-7,210,1984,6,22,27,1
Andrew Bogut,2006,2018,7-0,260,1984,13,22,34,0
Boniface N'Dong,2006,2006,7-0,198,1977,1,29,29,1
James Singleton,2006,2012,6-8,216,1981,7,25,31,1
C.J. Miles,2006,2018,6-6,225,1987,13,19,31,0
Aaron Miles,2006,2006,6-1,175,1983,1,23,23,1
Martynas Andriuskevicius,2006,2006,7-2,240,1986,1,20,20,1
Rawle Marshall,2006,2007,6-9,190,1982,2,24,25,1
Anthony Grundy,2006,2006,6-3,180,1979,1,27,27,1
Lou Williams,2006,2018,6-1,175,1986,13,20,32,0
Orien Greene,2006,2011,6-4,208,1982,6,24,29,1
Rashad McCants,2006,2009,6-4,207,1984,4,22,25,1
Gerald Green,2006,2017,6-7,205,1986,12,20,31,0
Deron Williams,2006,2017,6-3,200,1984,12,22,33,0
Kevin Burleson,2006,2006,6-3,205,1979,1,27,27,1
David Lee,2006,2017,6-9,245,1983,12,23,34,0
Devin Green,2006,2006,6-7,210,1982,1,24,24,1
Sean May,2006,2010,6-9,266,1984,5,22,26,1
Andrew Bynum,2006,2014,7-0,285,1987,9,19,27,0
Will Bynum,2006,2015,6-0,185,1983,10,23,32,0
Jason Maxiell,2006,2015,6-7,260,1983,10,23,32,0
Marvin Williams,2006,2018,6-9,237,1986,13,20,32,0
Alex Acker,2006,2009,6-5,185,1983,4,23,26,1
Ike Diogu,2006,2012,6-8,250,1983,7,23,29,1
Johan Petro,2006,2013,7-0,247,1986,8,20,27,0
Julius Hodge,2006,2007,6-7,210,1983,2,23,24,1
Shavlik Randolph,2006,2015,6-10,240,1983,10,23,32,0
Randy Holcomb,2006,2006,6-9,225,1979,1,27,27,1
Gerald Fitch,2006,2006,6-3,188,1982,1,24,24,1
Lawrence Roberts,2006,2007,6-9,240,1982,2,24,25,1
Dwayne Jones,2006,2010,6-11,250,1983,5,23,27,1
Monta Ellis,2006,2017,6-3,185,1985,12,21,32,0
Anthony Roberson,2006,2009,6-2,180,1983,4,23,26,1
Melvin Sanders,2006,2006,6-5,210,1981,1,25,25,1
Brandon Bass,2006,2017,6-8,250,1985,12,21,32,0
Dijon Thompson,2006,2007,6-7,195,1983,2,23,24,1
Stephen Graham,2006,2011,6-6,215,1982,6,24,29,1
Chris Taft,2006,2006,6-10,260,1985,1,21,21,1
Francisco Garcia,2006,2015,6-7,195,1981,10,25,34,0
Esteban Batista,2006,2007,6-10,270,1983,2,23,24,1
Earl Barron,2006,2015,7-0,250,1981,10,25,34,0
Alan Anderson,2006,2017,6-6,220,1982,12,24,35,0
Donell Taylor,2006,2007,6-6,180,1982,2,24,25,1
Noel Felix,2006,2006,6-9,225,1981,1,25,25,1
Amir Johnson,2006,2018,6-9,240,1987,13,19,31,0
Daniel Ewing,2006,2007,6-3,185,1983,2,23,24,1
Nate Robinson,2006,2016,5-9,180,1984,11,22,32,0
Sarunas Jasikevicius,2006,2007,6-4,195,1976,2,30,31,1
Jarrett Jack,2006,2018,6-3,200,1983,13,23,35,0
Joey Graham,2006,2011,6-7,225,1982,6,24,29,1
Von Wafer,2006,2012,6-5,210,1985,7,21,27,1
Channing Frye,2006,2018,6-11,255,1983,13,23,35,0
Charlie Villanueva,2006,2016,6-11,232,1984,11,22,32,0
Ryan Gomes,2006,2014,6-7,250,1982,9,24,32,0
Eddie Basden,2006,2006,6-5,215,1983,1,23,23,1
Deng Gai,2006,2006,6-9,250,1982,1,24,24,1
Salim Stoudamire,2006,2008,6-1,179,1982,3,24,26,1
Sharrod Ford,2006,2006,6-9,225,1982,1,24,24,1
Yaroslav Korolev,2006,2007,6-9,203,1987,2,19,20,1
Luke Schenscher,2006,2007,7-1,255,1982,2,24,25,1
Travis Diener,2006,2010,6-1,175,1982,5,24,28,1
Alex Scales,2006,2006,6-4,185,1978,1,28,28,1
Ronny Turiaf,2006,2015,6-10,249,1983,10,23,32,0
Ronnie Price,2006,2017,6-2,190,1983,12,23,34,0
Linas Kleiza,2006,2013,6-8,245,1985,8,21,28,0
Raymond Felton,2006,2018,6-1,205,1984,13,22,34,0
Josh Powell,2006,2014,6-9,225,1983,9,23,31,0
Cedric Bozeman,2007,2007,6-6,207,1983,1,24,24,1
Cedric Simmons,2007,2009,6-9,235,1986,3,21,23,1
Randy Foye,2007,2017,6-4,213,1983,11,24,34,0
Maurice Ager,2007,2011,6-5,202,1984,5,23,27,0
Jorge Garbajosa,2007,2008,6-9,245,1977,2,30,31,1
Andre Brown,2007,2009,6-9,245,1981,3,26,28,1
Mike Hall,2007,2007,6-8,230,1984,1,23,23,1
Ronnie Brewer,2007,2014,6-7,220,1985,8,22,29,0
Josh Boone,2007,2010,6-10,237,1984,4,23,26,1
Will Blalock,2007,2007,6-0,205,1983,1,24,24,1
Lynn Greer,2007,2007,6-2,175,1979,1,28,28,1
Shelden Williams,2007,2012,6-9,250,1983,6,24,29,0
Will Conroy,2007,2013,6-2,195,1982,7,25,31,0
Mardy Collins,2007,2010,6-6,220,1984,4,23,26,1
Steven Smith,2007,2007,6-8,235,1983,1,24,24,1
Paul Davis,2007,2010,6-11,270,1984,4,23,26,1
Andreas Glyniadakis,2007,2007,7-1,280,1981,1,26,26,1
Yakhouba Diawara,2007,2010,6-7,225,1982,4,25,28,1
James White,2007,2013,6-7,200,1982,7,25,31,0
Rodney Carney,2007,2011,6-7,205,1984,5,23,27,0
P.J. Tucker,2007,2018,6-6,245,1985,12,22,33,0
Daniel Gibson,2007,2013,6-2,190,1986,7,21,27,0
Quincy Douby,2007,2009,6-3,175,1984,3,23,25,1
Dee Brown,2007,2009,6-0,185,1984,3,23,25,1
Hassan Adams,2007,2009,6-4,220,1984,3,23,25,1
Craig Smith,2007,2012,6-7,250,1983,6,24,29,0
Vassilis Spanoulis,2007,2007,6-4,195,1982,1,25,25,1
Rudy Gay,2007,2018,6-8,230,1986,12,21,32,0
Tyrus Thomas,2007,2015,6-9,215,1986,9,21,29,0
Jordan Farmar,2007,2017,6-2,180,1986,11,21,31,0
Desmon Farmer,2007,2009,6-5,220,1981,3,26,28,1
Uros Slokar,2007,2007,6-10,238,1983,1,24,24,1
Justin Williams,2007,2008,6-10,225,1984,2,23,24,1
Marcus Williams,2007,2010,6-3,205,1985,4,22,25,1
Shannon Brown,2007,2015,6-4,205,1985,9,22,30,0
Shawne Williams,2007,2015,6-9,225,1986,9,21,29,0
Mickael Gelabale,2007,2013,6-7,215,1983,7,24,30,0
Marcus Vinicius,2007,2008,6-8,225,1984,2,23,24,1
Adam Morrison,2007,2010,6-8,205,1984,4,23,26,1
LaMarcus Aldridge,2007,2018,6-11,260,1985,12,22,33,0
David Noel,2007,2007,6-6,230,1984,1,23,23,1
Chris Quinn,2007,2013,6-2,185,1983,7,24,30,0
Tarence Kinsey,2007,2009,6-6,185,1984,3,23,25,1
James Augustine,2007,2008,6-10,235,1984,2,23,24,1
Steve Novak,2007,2017,6-10,225,1983,11,24,34,0
Ivan McFarlin,2007,2007,6-8,240,1982,1,25,25,1
Chris McCray,2007,2007,6-5,192,1984,1,23,23,1
Ryan Hollins,2007,2016,7-0,240,1984,10,23,32,0
Patrick O'Bryant,2007,2010,7-0,260,1986,4,21,24,1
Leon Powe,2007,2011,6-8,240,1984,5,23,27,0
Kelenna Azubuike,2007,2012,6-5,220,1983,6,24,29,0
Kevinn Pinkney,2007,2007,6-10,245,1983,1,24,24,1
Robert Hite,2007,2007,6-2,184,1984,1,23,23,1
J.J. Barea,2007,2018,6-0,185,1984,12,23,34,0
James Lang,2007,2007,6-10,285,1983,1,24,24,1
Andrea Bargnani,2007,2016,7-0,245,1985,10,22,31,0
Walter Herrmann,2007,2009,6-9,225,1979,3,28,30,1
Mouhamed Sene,2007,2009,6-11,230,1986,3,21,23,1
Damir Markota,2007,2007,6-10,225,1985,1,22,22,1
Renaldo Major,2007,2007,6-7,200,1982,1,25,25,1
Thabo Sefolosha,2007,2018,6-7,220,1984,12,23,34,0
Hilton Armstrong,2007,2014,6-11,235,1984,8,23,30,0
Solomon Jones,2007,2014,6-10,230,1984,8,23,30,0
Roger Powell,2007,2007,6-6,235,1983,1,24,24,1
Kyle Lowry,2007,2018,6-0,205,1986,12,21,32,0
Mile Ilic,2007,2007,7-1,230,1984,1,23,23,1
Allan Ray,2007,2007,6-2,190,1984,1,23,23,1
Paul Millsap,2007,2018,6-8,246,1985,12,22,33,0
Rajon Rondo,2007,2018,6-1,186,1986,12,21,32,0
Alexander Johnson,2007,2008,6-9,240,1983,2,24,25,1
Renaldo Balkman,2007,2012,6-8,208,1984,6,23,28,0
Pops Mensah-Bonsu,2007,2011,6-9,240,1983,5,24,28,0
Lou Amundson,2007,2016,6-9,220,1982,10,25,34,0
Sergio Rodriguez,2007,2017,6-3,176,1986,11,21,31,0
Brandon Roy,2007,2013,6-6,215,1984,7,23,29,0
Jeremy Richardson,2007,2009,6-6,185,1984,3,23,25,1
Ersan Ilyasova,2007,2018,6-10,235,1987,12,20,31,0
Bobby Jones,2007,2008,6-7,215,1984,2,23,24,1
J.J. Redick,2007,2018,6-4,190,1984,12,23,34,0
Randolph Morris,2007,2010,6-10,266,1986,4,21,24,1
Stephane Lasme,2008,2008,6-8,215,1982,1,26,26,1
Luis Scola,2008,2017,6-9,240,1980,10,28,37,0
Marcin Gortat,2008,2018,6-11,240,1984,11,24,34,0
Acie Law,2008,2011,6-3,195,1985,4,23,26,1
Arron Afflalo,2008,2018,6-5,210,1985,11,23,33,0
D.J. Strawberry,2008,2008,6-5,201,1985,1,23,23,1
Oleksiy Pecherov,2008,2010,7-0,232,1985,3,23,25,1
Darius Washington,2008,2008,6-2,195,1985,1,23,23,1
Kosta Perovic,2008,2008,7-2,240,1985,1,23,23,1
Javaris Crittenton,2008,2009,6-5,200,1987,2,21,22,1
Mike Conley,2008,2018,6-1,175,1987,11,21,31,0
Daequan Cook,2008,2013,6-5,205,1987,6,21,26,0
C.J. Watson,2008,2017,6-2,175,1984,10,24,33,0
Darryl Watkins,2008,2012,6-11,258,1984,5,24,28,0
Kevin Durant,2008,2018,6-9,240,1988,11,20,30,0
Carl Landry,2008,2016,6-9,248,1983,9,25,33,0
Al Thornton,2008,2011,6-8,220,1983,4,25,28,1
Al Horford,2008,2018,6-10,245,1986,11,22,32,0
Jared Dudley,2008,2018,6-7,225,1985,11,23,33,0
Coby Karl,2008,2010,6-5,215,1983,3,25,27,1
Thomas Gardner,2008,2009,6-5,225,1985,2,23,24,1
Blake Ahearn,2008,2012,6-2,190,1984,5,24,28,0
Cheikh Samb,2008,2009,7-1,245,1984,2,24,25,1
Alando Tucker,2008,2010,6-6,205,1984,3,24,26,1
Keith Langford,2008,2008,6-4,215,1983,1,25,25,1
Gabe Pruitt,2008,2009,6-4,170,1986,2,22,23,1
Guillermo Diaz,2008,2008,6-2,192,1985,1,23,23,1
Nick Fazekas,2008,2008,6-11,235,1985,1,23,23,1
Kasib Powell,2008,2008,6-7,215,1981,1,27,27,1
Lance Allred,2008,2008,6-11,250,1981,1,27,27,1
Morris Almond,2008,2012,6-6,225,1985,5,23,27,0
Glen Davis,2008,2015,6-9,289,1986,8,22,29,0
Jermareo Davidson,2008,2009,6-10,230,1984,2,24,25,1
Kyrylo Fesenko,2008,2012,7-1,288,1986,5,22,26,0
Chris Richard,2008,2010,6-9,270,1984,3,24,26,1
Yi Jianlian,2008,2012,7-0,240,1987,5,21,25,0
Rodney Stuckey,2008,2017,6-5,210,1986,10,22,31,0
Spencer Hawes,2008,2017,7-1,245,1988,10,20,29,0
Taurean Green,2008,2008,6-0,177,1986,1,22,22,1
Aaron Brooks,2008,2018,6-0,161,1985,11,23,33,0
Corey Brewer,2008,2018,6-9,186,1986,11,22,32,0
Jeff Green,2008,2018,6-9,235,1986,11,22,32,0
Marco Belinelli,2008,2018,6-5,210,1986,11,22,32,0
Sean Williams,2008,2012,6-10,235,1986,5,22,26,0
Juan Carlos Navarro,2008,2008,6-3,170,1980,1,28,28,1
Joakim Noah,2008,2018,6-11,230,1985,11,23,33,0
Ian Mahinmi,2008,2018,6-11,250,1986,11,22,32,0
Joel Anthony,2008,2017,6-9,245,1982,10,26,35,0
Aaron Gray,2008,2014,7-0,270,1984,7,24,30,0
Courtney Sims,2008,2009,6-10,245,1983,2,25,26,1
Brandan Wright,2008,2018,6-10,210,1987,11,21,31,0
Jason Smith,2008,2018,7-0,245,1986,11,22,32,0
Julian Wright,2008,2011,6-8,225,1987,4,21,24,1
Jamario Moon,2008,2012,6-8,205,1980,5,28,32,0
Josh McRoberts,2008,2017,6-10,240,1987,10,21,30,0
Nick Young,2008,2018,6-7,210,1985,11,23,33,0
Mario West,2008,2011,6-5,210,1984,4,24,27,1
Dominic McGuire,2008,2013,6-9,220,1985,6,23,28,0
Ramon Sessions,2008,2018,6-3,190,1986,11,22,32,0
Thaddeus Young,2008,2018,6-8,221,1988,11,20,30,0
Marcus Williams,2008,2009,6-7,205,1986,2,22,23,1
Mike Harris,2008,2014,6-6,240,1983,7,25,31,0
Wilson Chandler,2008,2018,6-8,225,1987,11,21,31,0
Demetris Nichols,2008,2009,6-8,216,1984,2,24,25,1
D.J. Augustin,2009,2018,6-0,183,1987,10,22,31,0
Chris Douglas-Roberts,2009,2015,6-7,200,1987,7,22,28,0
Malik Hairston,2009,2010,6-6,220,1987,2,22,23,1
Hamed Haddadi,2009,2013,7-2,254,1985,5,24,28,0
Anthony Randolph,2009,2014,6-10,205,1989,6,20,25,0
Joey Dorsey,2009,2015,6-8,268,1983,7,26,32,0
JaVale McGee,2009,2018,7-0,270,1988,10,21,30,0
Goran Dragic,2009,2018,6-3,190,1986,10,23,32,0
Sean Singletary,2009,2009,6-0,185,1985,1,24,24,1
Nicolas Batum,2009,2018,6-8,200,1988,10,21,30,0
Anthony Tolliver,2009,2018,6-8,240,1985,10,24,33,0
Darnell Jackson,2009,2011,6-9,253,1985,3,24,26,1
Sun Yue,2009,2009,6-9,205,1985,1,24,24,1
Nathan Jawai,2009,2010,6-10,280,1986,2,23,24,1
Derrick Rose,2009,2018,6-3,190,1988,10,21,30,0
Dontell Jefferson,2009,2009,6-5,195,1983,1,26,26,1
Rudy Fernandez,2009,2012,6-6,185,1985,4,24,27,1
Mike Taylor,2009,2009,6-2,165,1986,1,23,23,1
DeMarcus Nelson,2009,2009,6-4,200,1985,1,24,24,1
Anthony Morrow,2009,2017,6-5,210,1985,9,24,32,0
Othello Hunter,2009,2010,6-8,225,1986,2,23,24,1
Trey Johnson,2009,2012,6-5,218,1984,4,25,28,1
Jason Thompson,2009,2016,6-11,250,1986,8,23,30,0
Marc Gasol,2009,2018,7-1,255,1985,10,24,33,0
Bobby Brown,2009,2018,6-2,175,1984,10,25,34,0
Brandon Rush,2009,2017,6-6,220,1985,9,24,32,0
DeAndre Jordan,2009,2018,6-11,265,1988,10,21,30,0
Danilo Gallinari,2009,2018,6-10,225,1988,10,21,30,0
Jerryd Bayless,2009,2018,6-3,200,1988,10,21,30,0
Marreese Speights,2009,2018,6-10,255,1987,10,22,31,0
Walter Sharpe,2009,2009,6-9,245,1986,1,23,23,1
Alexis Ajinca,2009,2017,7-2,248,1988,9,21,29,0
Henry Walker,2009,2015,6-6,220,1987,7,22,28,0
Darrell Arthur,2009,2018,6-9,235,1988,10,21,30,0
Roy Hibbert,2009,2017,7-2,270,1986,9,23,31,0
Jawad Williams,2009,2011,6-9,218,1983,3,26,28,1
Courtney Lee,2009,2018,6-5,200,1985,10,24,33,0
Cartier Martin,2009,2015,6-7,220,1984,7,25,31,0
Michael Beasley,2009,2018,6-9,235,1989,10,20,29,0
Joe Crawford,2009,2009,6-5,210,1986,1,23,23,1
Mario Chalmers,2009,2018,6-2,190,1986,10,23,32,0
Eric Gordon,2009,2018,6-4,215,1988,10,21,30,0
D.J. White,2009,2014,6-9,251,1986,6,23,28,0
Russell Westbrook,2009,2018,6-3,200,1988,10,21,30,0
Kyle Weaver,2009,2011,6-6,201,1986,3,23,25,1
Brook Lopez,2009,2018,7-0,275,1988,10,21,30,0
Robin Lopez,2009,2018,7-0,255,1988,10,21,30,0
Kevin Love,2009,2018,6-10,251,1988,10,21,30,0
Sonny Weems,2009,2016,6-6,205,1986,8,23,30,0
George Hill,2009,2018,6-3,188,1986,10,23,32,0
Steven Hill,2009,2009,7-0,248,1985,1,24,24,1
J.J. Hickson,2009,2016,6-9,242,1988,8,21,28,0
Rob Kurz,2009,2009,6-9,232,1985,1,24,24,1
Luc Mbah a Moute,2009,2018,6-8,230,1986,10,23,32,0
Roko Ukic,2009,2010,6-5,183,1984,2,25,26,1
Donte Greene,2009,2012,6-11,226,1988,4,21,24,1
Ryan Anderson,2009,2018,6-10,240,1988,10,21,30,0
J.R. Giddens,2009,2010,6-5,215,1985,2,24,25,1
O.J. Mayo,2009,2016,6-5,210,1987,8,22,29,0
Kosta Koufos,2009,2018,7-0,265,1989,10,20,29,0
Greg Oden,2009,2014,7-0,250,1988,6,21,26,0
Joe Alexander,2009,2010,6-8,230,1986,2,23,24,1
Jermaine Taylor,2010,2011,6-4,210,1986,2,24,25,1
Jeff Ayres,2010,2016,6-9,240,1987,7,23,29,0
David Andersen,2010,2011,6-11,245,1980,2,30,31,1
Austin Daye,2010,2015,6-11,220,1988,6,22,27,0
Jonas Jerebko,2010,2018,6-10,231,1987,9,23,31,0
Byron Mullens,2010,2014,7-0,275,1989,5,21,25,0
Eric Maynor,2010,2014,6-3,175,1987,5,23,27,0
DeJuan Blair,2010,2016,6-7,270,1989,7,21,27,0
Rodrigue Beaubois,2010,2013,6-0,170,1988,4,22,25,1
Othyus Jeffers,2010,2014,6-5,200,1985,5,25,29,0
Chase Budinger,2010,2016,6-7,209,1988,7,22,28,0
Earl Clark,2010,2015,6-10,225,1988,6,22,27,0
A.J. Price,2010,2015,6-2,181,1986,6,24,29,0
Sam Young,2010,2013,6-6,220,1985,4,25,28,1
Reggie Williams,2010,2017,6-6,205,1986,8,24,31,0
Jonny Flynn,2010,2012,6-0,185,1989,3,21,23,1
DaJuan Summers,2010,2013,6-8,230,1988,4,22,25,1
Brandon Jennings,2010,2017,6-1,170,1989,8,21,28,0
Darren Collison,2010,2018,6-0,175,1987,9,23,31,0
Toney Douglas,2010,2017,6-2,195,1986,8,24,31,0
Jeff Teague,2010,2018,6-2,186,1988,9,22,30,0
Stephen Curry,2010,2018,6-3,190,1988,9,22,30,0
Wesley Matthews,2010,2018,6-5,220,1986,9,24,32,0
JamesOn Curry,2010,2010,6-3,190,1986,1,24,24,1
Marcus Thornton,2010,2017,6-4,205,1987,8,23,30,0
Marcus Landry,2010,2010,6-7,230,1985,1,25,25,1
Jon Brockman,2010,2012,6-7,255,1987,3,23,25,1
Wayne Ellington,2010,2018,6-4,200,1987,9,23,31,0
Ty Lawson,2010,2017,5-11,195,1987,8,23,30,0
Terrence Williams,2010,2013,6-6,220,1987,4,23,26,1
Antonio Anderson,2010,2010,6-6,215,1985,1,25,25,1
Dante Cunningham,2010,2018,6-8,230,1987,9,23,31,0
Derrick Brown,2010,2012,6-7,225,1987,3,23,25,1
James Johnson,2010,2018,6-9,250,1987,9,23,31,0
Oliver Lafayette,2010,2010,6-2,190,1984,1,26,26,1
Jodie Meeks,2010,2018,6-4,210,1987,9,23,31,0
DeMarre Carroll,2010,2018,6-8,215,1986,9,24,32,0
Hasheem Thabeet,2010,2014,7-3,263,1987,5,23,27,0
Omri Casspi,2010,2018,6-9,225,1988,9,22,30,0
Garrett Temple,2010,2018,6-6,195,1986,9,24,32,0
Patty Mills,2010,2018,6-0,185,1988,9,22,30,0
Tyreke Evans,2010,2018,6-6,220,1989,9,21,29,0
DeMar DeRozan,2010,2018,6-7,221,1989,9,21,29,0
Gerald Henderson,2010,2017,6-5,215,1987,8,23,30,0
Jrue Holiday,2010,2018,6-4,205,1990,9,20,28,0
Tyler Hansbrough,2010,2016,6-9,250,1985,7,25,31,0
Danny Green,2010,2018,6-6,215,1987,9,23,31,0
Serge Ibaka,2010,2018,6-10,235,1989,9,21,29,0
James Harden,2010,2018,6-5,220,1989,9,21,29,0
Chris Hunter,2010,2010,6-11,240,1984,1,26,26,1
Alonzo Gee,2010,2017,6-6,225,1987,8,23,30,0
Taylor Griffin,2010,2010,6-7,238,1986,1,24,24,1
Cedric Jackson,2010,2010,6-3,191,1986,1,24,24,1
Taj Gibson,2010,2018,6-9,225,1985,9,25,33,0
Jordan Hill,2010,2017,6-10,235,1987,8,23,30,0
Sundiata Gaines,2010,2012,6-1,185,1986,3,24,26,1
Lester Hudson,2010,2015,6-3,190,1984,6,26,31,0
Trey Gilder,2010,2010,6-9,185,1985,1,25,25,1
Greivis Vasquez,2011,2017,6-6,217,1987,7,24,30,0
Solomon Alabi,2011,2012,7-1,251,1988,2,23,24,1
Quincy Pondexter,2011,2018,6-7,220,1988,8,23,30,0
Larry Owens,2011,2012,6-7,210,1983,2,28,29,1
DeMarcus Cousins,2011,2018,6-11,270,1990,8,21,28,0
Derrick Favors,2011,2018,6-10,265,1991,8,20,27,0
Omer Asik,2011,2018,7-0,255,1986,8,25,32,0
Andy Rautins,2011,2011,6-4,190,1986,1,25,25,1
Chris Johnson,2011,2013,6-11,210,1985,3,26,28,1
Greg Monroe,2011,2018,6-11,265,1990,8,21,28,0
Dexter Pittman,2011,2014,6-11,308,1988,4,23,26,1
Paul George,2011,2018,6-9,220,1990,8,21,28,0
Hassan Whiteside,2011,2018,7-0,265,1989,8,22,29,0
Christian Eyenga,2011,2012,6-5,210,1989,2,22,23,1
Larry Sanders,2011,2017,6-11,235,1988,7,23,29,0
Luke Babbitt,2011,2018,6-9,225,1989,8,22,29,0
Mustafa Shakur,2011,2014,6-3,190,1984,4,27,30,1
Lance Stephenson,2011,2018,6-5,230,1990,8,21,28,0
Blake Griffin,2011,2018,6-10,251,1989,8,22,29,0
Dominique Jones,2011,2013,6-4,215,1988,3,23,25,1
Manny Harris,2011,2017,6-5,185,1989,7,22,28,0
Semih Erden,2011,2012,7-0,240,1986,2,25,26,1
Zabian Dowdell,2011,2011,6-3,191,1984,1,27,27,1
Garret Siler,2011,2011,6-11,305,1986,1,25,25,1
Sherron Collins,2011,2011,5-11,205,1987,1,24,24,1
Jeremy Evans,2011,2016,6-9,200,1987,6,24,29,0
Timofey Mozgov,2011,2018,7-1,275,1986,8,25,32,0
Wesley Johnson,2011,2018,6-7,215,1987,8,24,31,0
Tiago Splitter,2011,2017,6-11,245,1985,7,26,32,0
Evan Turner,2011,2018,6-7,220,1988,8,23,30,0
Samardo Samuels,2011,2013,6-9,260,1989,3,22,24,1
Kevin Seraphin,2011,2017,6-9,285,1989,7,22,28,0
Ekpe Udoh,2011,2018,6-10,240,1987,8,24,31,0
Patrick Ewing,2011,2011,6-8,235,1984,1,27,27,1
Derrick Caracter,2011,2011,6-9,275,1988,1,23,23,1
Ben Uzoh,2011,2012,6-3,205,1988,2,23,24,1
Armon Johnson,2011,2012,6-3,195,1989,2,22,23,1
Ed Davis,2011,2018,6-10,240,1989,8,22,29,0
Trevor Booker,2011,2018,6-8,228,1987,8,24,31,0
Lazar Hayward,2011,2013,6-6,225,1986,3,25,27,1
Avery Bradley,2011,2018,6-2,180,1990,8,21,28,0
Craig Brackins,2011,2012,6-10,230,1987,2,24,25,1
Pape Sy,2011,2011,6-7,225,1988,1,23,23,1
Nikola Pekovic,2011,2016,6-11,307,1986,6,25,30,0
Gary Neal,2011,2017,6-4,210,1984,7,27,33,0
Patrick Patterson,2011,2018,6-9,230,1989,8,22,29,0
Hamady N'Diaye,2011,2014,7-0,235,1987,4,24,27,1
Jordan Crawford,2011,2018,6-4,195,1988,8,23,30,0
Willie Warren,2011,2011,6-4,203,1989,1,22,22,1
Cole Aldrich,2011,2018,6-11,250,1988,8,23,30,0
Gary Forbes,2011,2012,6-7,220,1985,2,26,27,1
James Anderson,2011,2016,6-6,213,1989,6,22,27,0
Jeremy Lin,2011,2018,6-3,200,1988,8,23,30,0
Al-Farouq Aminu,2011,2018,6-9,220,1990,8,21,28,0
Xavier Henry,2011,2015,6-6,220,1991,5,20,24,0
Jeff Adrien,2011,2015,6-7,245,1986,5,25,29,0
Luke Harangody,2011,2012,6-8,246,1988,2,23,24,1
Damion James,2011,2014,6-7,225,1987,4,24,27,1
Gordon Hayward,2011,2018,6-8,226,1990,8,21,28,0
Marcus Cousin,2011,2011,6-11,245,1986,1,25,25,1
Devin Ebanks,2011,2013,6-9,215,1989,3,22,24,1
Gani Lawal,2011,2011,6-9,234,1988,1,23,23,1
John Wall,2011,2018,6-4,195,1990,8,21,28,0
Eric Bledsoe,2011,2018,6-1,205,1989,8,22,29,0
Eugene Jeter,2011,2011,5-11,175,1983,1,28,28,1
Landry Fields,2011,2015,6-7,210,1988,5,23,27,0
Ish Smith,2011,2018,6-0,175,1988,8,23,30,0
Cory Joseph,2012,2018,6-3,193,1991,7,21,27,0
Elliot Williams,2012,2016,6-5,190,1989,5,23,27,0
Alec Burks,2012,2018,6-6,214,1991,7,21,27,0
Iman Shumpert,2012,2018,6-5,220,1990,7,22,28,0
Derrick Williams,2012,2017,6-8,240,1991,6,21,26,0
Enes Kanter,2012,2018,6-11,245,1992,7,20,26,0
E'Twaun Moore,2012,2018,6-4,191,1989,7,23,29,0
Darington Hobson,2012,2012,6-7,210,1987,1,25,25,1
Josh Selby,2012,2013,6-2,183,1991,2,21,22,1
Walker Russell,2012,2012,6-0,170,1982,1,30,30,1
Dennis Horner,2012,2012,6-9,230,1988,1,24,24,1
Nikola Vucevic,2012,2018,7-0,260,1990,7,22,28,0
Terrel Harris,2012,2013,6-5,190,1987,2,25,26,1
Jerome Jordan,2012,2015,7-0,253,1986,4,26,29,1
Norris Cole,2012,2017,6-2,175,1988,6,24,29,0
Nolan Smith,2012,2013,6-2,185,1988,2,24,25,1
Jeremy Pargo,2012,2013,6-2,219,1986,2,26,27,1
Jerome Dyson,2012,2012,6-3,180,1987,1,25,25,1
Andrew Goudelock,2012,2016,6-3,200,1988,5,24,28,0
Donald Sloan,2012,2016,6-3,205,1988,5,24,28,0
Jordan Williams,2012,2012,6-10,260,1990,1,22,22,1
Shelvin Mack,2012,2018,6-3,203,1990,7,22,28,0
Tobias Harris,2012,2018,6-9,235,1992,7,20,26,0
Mickell Gladness,2012,2012,6-11,220,1986,1,26,26,1
Kawhi Leonard,2012,2018,6-7,230,1991,7,21,27,0
Lavoy Allen,2012,2017,6-9,260,1989,6,23,28,0
Chris Wright,2012,2014,6-8,226,1988,3,24,26,1
Eric Dawson,2012,2012,6-9,250,1984,1,28,28,1
Brandon Knight,2012,2017,6-3,189,1991,6,21,26,0
Chandler Parsons,2012,2018,6-10,230,1988,7,24,30,0
Justin Dentmon,2012,2013,5-11,185,1985,2,27,28,1
Daniel Orton,2012,2014,6-10,255,1990,3,22,24,1
Gustavo Ayon,2012,2014,6-10,250,1985,3,27,29,1
Travis Leslie,2012,2012,6-4,205,1990,1,22,22,1
Jon Leuer,2012,2018,6-10,228,1989,7,23,29,0
Malcolm Lee,2012,2015,6-5,200,1990,4,22,25,1
Courtney Fortson,2012,2012,5-11,185,1988,1,24,24,1
Edwin Ubiles,2012,2012,6-6,204,1986,1,26,26,1
Vernon Macklin,2012,2012,6-10,227,1986,1,26,26,1
Jeremy Tyler,2012,2014,6-10,260,1991,3,21,23,1
Jan Vesely,2012,2014,6-11,240,1990,3,22,24,1
Bismack Biyombo,2012,2018,6-9,255,1992,7,20,26,0
Derrick Byars,2012,2012,6-7,220,1984,1,28,28,1
Jerry Smith,2012,2012,6-2,190,1987,1,25,25,1
Greg Smith,2012,2016,6-10,250,1991,5,21,25,0
D.J. Kennedy,2012,2012,6-6,215,1989,1,23,23,1
Kemba Walker,2012,2018,6-1,172,1990,7,22,28,0
Cory Higgins,2012,2013,6-5,180,1989,2,23,24,1
Tyler Honeycutt,2012,2013,6-8,188,1990,2,22,23,1
Darius Morris,2012,2015,6-4,190,1991,4,21,24,1
DeAndre Liggins,2012,2018,6-6,209,1988,7,24,30,0
Jimmy Butler,2012,2018,6-8,236,1989,7,23,29,0
Klay Thompson,2012,2018,6-7,215,1990,7,22,28,0
Charles Jenkins,2012,2013,6-3,220,1989,2,23,24,1
Markieff Morris,2012,2018,6-10,245,1989,7,23,29,0
Trey Thompkins,2012,2012,6-10,245,1990,1,22,22,1
Jimmer Fredette,2012,2016,6-2,195,1989,5,23,27,0
Jeff Foote,2012,2012,7-0,265,1987,1,25,25,1
Chris Singleton,2012,2014,6-8,230,1989,3,23,25,1
Reggie Jackson,2012,2018,6-3,208,1990,7,22,28,0
JaJuan Johnson,2012,2012,6-10,221,1989,1,23,23,1
Keith Benson,2012,2012,6-11,240,1988,1,24,24,1
Julyan Stone,2012,2018,6-6,200,1988,7,24,30,0
Kenneth Faried,2012,2018,6-8,228,1989,7,23,29,0
Justin Harper,2012,2017,6-10,225,1989,6,23,28,0
Ivan Johnson,2012,2013,6-8,230,1984,2,28,29,1
Greg Stiemsma,2012,2015,6-11,260,1985,4,27,30,1
Josh Harrellson,2012,2014,6-10,275,1989,3,23,25,1
Ryan Reid,2012,2012,6-8,232,1986,1,26,26,1
Kyrie Irving,2012,2018,6-3,193,1992,7,20,26,0
MarShon Brooks,2012,2014,6-5,200,1989,3,23,25,1
Xavier Silas,2012,2012,6-5,205,1988,1,24,24,1
Ricky Rubio,2012,2018,6-4,194,1990,7,22,28,0
Mychel Thompson,2012,2012,6-6,211,1988,1,24,24,1
Lance Thomas,2012,2018,6-8,235,1988,7,24,30,0
Marcus Morris,2012,2018,6-9,235,1989,7,23,29,0
Malcolm Thomas,2012,2015,6-9,225,1988,4,24,27,1
Jordan Hamilton,2012,2016,6-7,220,1990,5,22,26,0
Isaiah Thomas,2012,2017,5-9,185,1989,6,23,28,0
Tristan Thompson,2012,2018,6-9,238,1991,7,21,27,0
Carldell Johnson,2012,2012,5-10,180,1983,1,29,29,1
Fab Melo,2013,2013,7-0,255,1990,1,23,23,1
Jared Cunningham,2013,2016,6-4,195,1991,4,22,25,1
Jonas Valanciunas,2013,2018,7-0,265,1992,6,21,26,0
Terrence Ross,2013,2018,6-7,206,1991,6,22,27,0
Festus Ezeli,2013,2016,6-11,255,1989,4,24,27,1
Maurice Harkless,2013,2018,6-9,215,1993,6,20,25,0
Orlando Johnson,2013,2016,6-5,220,1989,4,24,27,1
Scott Machado,2013,2013,6-1,205,1990,1,23,23,1
Austin Rivers,2013,2018,6-4,200,1992,6,21,26,0
Henry Sims,2013,2016,6-10,248,1990,4,23,26,1
Jae Crowder,2013,2018,6-6,235,1990,6,23,28,0
Khris Middleton,2013,2018,6-8,234,1991,6,22,27,0
Maalik Wayns,2013,2014,6-2,200,1991,2,22,23,1
Tornike Shengelia,2013,2014,6-9,217,1991,2,22,23,1
Jeffery Taylor,2013,2015,6-7,225,1989,3,24,26,1
Tyshawn Taylor,2013,2014,6-3,185,1990,2,23,24,1
Joel Freeland,2013,2015,6-10,250,1987,3,26,28,1
Marquis Teague,2013,2014,6-2,189,1993,2,20,21,1
Doron Lamb,2013,2014,6-4,210,1991,2,22,23,1
Anthony Davis,2013,2018,6-10,253,1993,6,20,25,0
Jeremy Lamb,2013,2018,6-5,185,1992,6,21,26,0
Mirza Teletovic,2013,2018,6-9,242,1985,6,28,33,0
Bradley Beal,2013,2018,6-5,207,1993,6,20,25,0
Josh Akognon,2013,2013,5-11,185,1986,1,27,27,1
Tyler Zeller,2013,2018,7-0,253,1990,6,23,28,0
Chris Johnson,2013,2016,6-6,206,1990,4,23,26,1
Miles Plumlee,2013,2018,6-11,249,1988,6,25,30,0
Will Barton,2013,2018,6-6,175,1991,6,22,27,0
Viacheslav Kravtsov,2013,2014,7-0,260,1987,2,26,27,1
Luke Zeller,2013,2013,6-11,245,1987,1,26,26,1
Dion Waiters,2013,2018,6-4,225,1991,6,22,27,0
Chris Wright,2013,2013,6-1,210,1989,1,24,24,1
Jarvis Varnado,2013,2014,6-9,230,1988,2,25,26,1
Patrick Beverley,2013,2018,6-1,185,1988,6,25,30,0
Nando De Colo,2013,2014,6-5,200,1987,2,26,27,1
Justin Holiday,2013,2018,6-6,185,1989,6,24,29,0
Kendall Marshall,2013,2016,6-4,200,1991,4,22,25,1
Kevin Murphy,2013,2013,6-5,185,1990,1,23,23,1
Donatas Motiejunas,2013,2017,7-0,222,1990,5,23,27,0
Darius Miller,2013,2018,6-8,235,1990,6,23,28,0
Robert Sacre,2013,2016,7-0,270,1989,4,24,27,1
Andrew Nicholson,2013,2017,6-9,250,1989,5,24,28,0
Chris Copeland,2013,2016,6-9,239,1984,4,29,32,1
Harrison Barnes,2013,2018,6-8,210,1992,6,21,26,0
Kyle O'Quinn,2013,2018,6-10,250,1990,6,23,28,0
Mike Scott,2013,2018,6-8,237,1988,6,25,30,0
Andre Drummond,2013,2018,6-11,279,1993,6,20,25,0
Kim English,2013,2013,6-6,200,1988,1,25,25,1
Thomas Robinson,2013,2017,6-10,237,1991,5,22,26,0
Bernard James,2013,2015,6-10,240,1985,3,28,30,1
Kris Joseph,2013,2013,6-7,210,1988,1,25,25,1
Damian Lillard,2013,2018,6-3,195,1990,6,23,28,0
Quincy Miller,2013,2015,6-9,210,1992,3,21,23,1
DeQuan Jones,2013,2013,6-8,221,1990,1,23,23,1
Evan Fournier,2013,2018,6-7,205,1992,6,21,26,0
Jared Sullinger,2013,2017,6-9,260,1992,5,21,25,0
Arnett Moultrie,2013,2014,6-11,249,1990,2,23,24,1
Kevin Jones,2013,2013,6-8,251,1989,1,24,24,1
Alexey Shved,2013,2015,6-6,190,1988,3,25,27,1
John Henson,2013,2018,6-11,229,1990,6,23,28,0
Terrence Jones,2013,2017,6-9,252,1992,5,21,25,0
Tony Wroten,2013,2016,6-6,205,1993,4,20,23,1
Perry Jones,2013,2015,6-11,235,1991,3,22,24,1
Quincy Acy,2013,2018,6-7,240,1990,6,23,28,0
Aron Baynes,2013,2018,6-10,260,1986,6,27,32,0
Kyle Singler,2013,2018,6-8,228,1988,6,25,30,0
Victor Claver,2013,2015,6-9,224,1988,3,25,27,1
Meyers Leonard,2013,2018,7-1,245,1992,6,21,26,0
John Jenkins,2013,2017,6-4,215,1991,5,22,26,0
Kent Bazemore,2013,2018,6-5,201,1989,6,24,29,0
Draymond Green,2013,2018,6-7,230,1990,6,23,28,0
Diante Garrett,2013,2014,6-4,190,1988,2,25,26,1
Pablo Prigioni,2013,2016,6-3,185,1977,4,36,39,1
Tim Ohlbrecht,2013,2013,6-11,255,1988,1,25,25,1
Michael Kidd-Gilchrist,2013,2018,6-7,232,1993,6,20,25,0
Darius Johnson-Odom,2013,2014,6-2,215,1989,2,24,25,1
Ben Hansbrough,2013,2013,6-3,203,1987,1,26,26,1
Brian Roberts,2013,2017,6-1,173,1985,5,28,32,0
Dionte Christmas,2014,2014,6-5,205,1986,1,28,28,1
Troy Daniels,2014,2018,6-4,205,1991,5,23,27,0
Seth Curry,2014,2017,6-2,185,1990,4,24,27,1
Ricky Ledo,2014,2015,6-7,195,1992,2,22,23,1
Rudy Gobert,2014,2018,7-1,245,1992,5,22,26,0
Alex Len,2014,2018,7-1,260,1993,5,21,25,0
Andre Roberson,2014,2018,6-7,210,1991,5,23,27,0
Anthony Bennett,2014,2017,6-8,245,1993,4,21,24,1
Carrick Felix,2014,2014,6-6,201,1990,1,24,24,1
Dennis Schroder,2014,2018,6-1,172,1993,5,21,25,0
Giannis Antetokounmpo,2014,2018,6-11,222,1994,5,20,24,0
Gal Mekel,2014,2015,6-3,191,1988,2,26,27,1
Nemanja Nedovic,2014,2014,6-3,192,1991,1,23,23,1
Nate Wolters,2014,2018,6-4,190,1991,5,23,27,0
Solomon Hill,2014,2017,6-7,225,1991,4,23,26,1
Robert Covington,2014,2018,6-9,215,1990,5,24,28,0
Shabazz Muhammad,2014,2018,6-6,223,1992,5,22,26,0
Casper Ware,2014,2014,5-10,175,1990,1,24,24,1
Tim Hardaway,2014,2018,6-6,205,1992,5,22,26,0
Mike Muscala,2014,2018,6-11,240,1991,5,23,27,0
Tony Snell,2014,2018,6-7,200,1991,5,23,27,0
Jamaal Franklin,2014,2015,6-5,191,1991,2,23,24,1
Shane Larkin,2014,2018,5-11,175,1992,5,22,26,0
Allen Crabbe,2014,2018,6-6,210,1992,5,22,26,0
Archie Goodwin,2014,2017,6-5,200,1994,4,20,23,1
Justin Hamilton,2014,2017,7-0,260,1990,4,24,27,1
Jeff Withey,2014,2018,7-0,231,1990,5,24,28,0
Ian Clark,2014,2018,6-3,175,1991,5,23,27,0
Shane Edwards,2014,2014,6-7,220,1987,1,27,27,1
Ognjen Kuzmic,2014,2015,7-1,251,1990,2,24,25,1
Ben McLemore,2014,2018,6-5,195,1993,5,21,25,0
Kentavious Caldwell-Pope,2014,2018,6-5,205,1993,5,21,25,0
Pero Antic,2014,2015,6-11,260,1982,2,32,33,1
Elias Harris,2014,2014,6-8,239,1989,1,25,25,1
Nick Calathes,2014,2015,6-6,213,1989,2,25,26,1
Phil Pressey,2014,2016,5-11,175,1991,3,23,25,1
Luigi Datome,2014,2015,6-8,215,1987,2,27,28,1
Victor Oladipo,2014,2018,6-4,210,1992,5,22,26,0
Dwight Buycks,2014,2015,6-3,190,1989,2,25,26,1
Toure' Murry,2014,2015,6-5,195,1989,2,25,26,1
Cody Zeller,2014,2018,7-0,240,1992,5,22,26,0
Jorge Gutierrez,2014,2016,6-3,191,1988,3,26,28,1
Robbie Hummel,2014,2015,6-8,215,1989,2,25,26,1
Scotty Hopson,2014,2014,6-7,204,1989,1,25,25,1
Ryan Kelly,2014,2017,6-11,230,1991,4,23,26,1
Sergey Karasev,2014,2016,6-7,208,1993,3,21,23,1
Ray McCallum,2014,2016,6-3,190,1991,3,23,25,1
Hollis Thompson,2014,2017,6-8,206,1991,4,23,26,1
Miroslav Raduljica,2014,2015,7-0,250,1988,2,26,27,1
Lorenzo Brown,2014,2018,6-5,189,1990,5,24,28,0
Trey Burke,2014,2017,6-1,191,1992,4,22,25,1
C.J. McCollum,2014,2018,6-3,190,1991,5,23,27,0
Reggie Bullock,2014,2018,6-7,205,1991,5,23,27,0
Tony Mitchell,2014,2014,6-6,216,1989,1,25,25,1
Tony Mitchell,2014,2014,6-8,235,1992,1,22,22,1
James Nunnally,2014,2014,6-7,205,1990,1,24,24,1
D.J. Stephens,2014,2014,6-5,188,1990,1,24,24,1
Kelly Olynyk,2014,2018,7-0,238,1991,5,23,27,0
Isaiah Canaan,2014,2018,6-0,201,1991,5,23,27,0
Gorgui Dieng,2014,2018,6-11,241,1990,5,24,28,0
Peyton Siva,2014,2014,6-0,185,1990,1,24,24,1
Vitor Faverani,2014,2014,6-11,260,1988,1,26,26,1
Royce White,2014,2014,6-8,270,1991,1,23,23,1
Mason Plumlee,2014,2018,6-11,245,1990,5,24,28,0
Vander Blue,2014,2018,6-4,200,1992,5,22,26,0
James Southerland,2014,2014,6-8,215,1990,1,24,24,1
Otto Porter,2014,2018,6-8,198,1993,5,21,25,0
Dewayne Dedmon,2014,2018,7-0,245,1989,5,25,29,0
Brandon Davies,2014,2015,6-10,240,1991,2,23,24,1
Steven Adams,2014,2018,7-0,255,1993,5,21,25,0
Matthew Dellavedova,2014,2018,6-4,198,1990,5,24,28,0
Michael Carter-Williams,2014,2018,6-6,190,1991,5,23,27,0
Glen Rice,2014,2015,6-6,206,1991,2,23,24,1
Chris Babb,2014,2014,6-5,225,1990,1,24,24,1
Arinze Onuaku,2014,2017,6-9,255,1987,4,27,30,1
Adonis Thomas,2014,2014,6-7,200,1993,1,21,21,1
Chris Smith,2014,2014,6-2,200,1987,1,27,27,1
Erik Murphy,2014,2014,6-10,230,1990,1,24,24,1
Joe Harris,2015,2018,6-6,219,1991,4,24,27,1
Jerami Grant,2015,2018,6-8,210,1994,4,21,24,1
Mitch McGary,2015,2016,6-10,255,1992,2,23,24,1
Shabazz Napier,2015,2018,6-1,175,1991,4,24,27,1
Doug McDermott,2015,2018,6-8,225,1992,4,23,26,1
Jusuf Nurkic,2015,2018,7-0,280,1994,4,21,24,1
Marcus Smart,2015,2018,6-4,220,1994,4,21,24,1
Markel Brown,2015,2016,6-3,190,1992,2,23,24,1
Kostas Papanikolaou,2015,2016,6-8,225,1990,2,25,26,1
Adreian Payne,2015,2018,6-10,237,1991,4,24,27,1
Will Cherry,2015,2015,6-0,185,1991,1,24,24,1
K.J. McDaniels,2015,2017,6-6,205,1993,3,22,24,1
Travis Wear,2015,2015,6-10,230,1990,1,25,25,1
Johnny O'Bryant,2015,2018,6-9,257,1993,4,22,25,1
Gary Harris,2015,2018,6-4,210,1994,4,21,24,1
James Michael McAdoo,2015,2018,6-9,230,1993,4,22,25,1
Nerlens Noel,2015,2018,6-11,228,1994,4,21,24,1
Patrick Christopher,2015,2015,6-5,209,1988,1,27,27,1
Jabari Parker,2015,2017,6-8,250,1995,3,20,22,1
Nikola Mirotic,2015,2018,6-10,220,1991,4,24,27,1
Bruno Caboclo,2015,2018,6-9,218,1995,4,20,23,1
Lucas Nogueira,2015,2018,7-0,241,1992,4,23,26,1
Jordan Clarkson,2015,2018,6-5,194,1992,4,23,26,1
C.J. Wilcox,2015,2017,6-5,195,1990,3,25,27,1
Andrew Wiggins,2015,2018,6-8,199,1995,4,20,23,1
Furkan Aldemir,2015,2015,6-10,240,1991,1,24,24,1
Kalin Lucas,2015,2015,6-1,195,1989,1,26,26,1
Erick Green,2015,2016,6-4,185,1991,2,24,25,1
Bojan Bogdanovic,2015,2018,6-8,216,1989,4,26,29,1
P.J. Hairston,2015,2016,6-6,230,1992,2,23,24,1
Shayne Whittington,2015,2016,6-11,250,1991,2,24,25,1
Jerel McNeal,2015,2015,6-3,200,1987,1,28,28,1
Jabari Brown,2015,2015,6-4,215,1992,1,23,23,1
Clint Capela,2015,2018,6-10,240,1994,4,21,24,1
JaMychal Green,2015,2018,6-9,227,1990,4,25,28,1
Kyle Anderson,2015,2018,6-9,230,1993,4,22,25,1
Devyn Marble,2015,2016,6-6,200,1992,2,23,24,1
Zach LaVine,2015,2017,6-5,189,1995,3,20,22,1
Rodney Hood,2015,2018,6-8,206,1992,4,23,26,1
Andre Dawkins,2015,2015,6-5,215,1991,1,24,24,1
James Young,2015,2017,6-6,215,1995,3,20,22,1
Dwight Powell,2015,2018,6-11,240,1991,4,24,27,1
Alex Kirk,2015,2015,7-0,245,1991,1,24,24,1
Spencer Dinwiddie,2015,2018,6-6,200,1993,4,22,25,1
Eric Moreland,2015,2018,6-10,238,1991,4,24,27,1
Sean Kilpatrick,2015,2018,6-4,210,1990,4,25,28,1
JaKarr Sampson,2015,2018,6-9,214,1993,4,22,25,1
David Wear,2015,2015,6-10,230,1990,1,25,25,1
Zoran Dragic,2015,2015,6-5,200,1989,1,26,26,1
Larry Drew,2015,2015,6-2,180,1990,1,25,25,1
Cameron Bairstow,2015,2016,6-9,250,1990,2,25,26,1
Julius Randle,2015,2018,6-9,250,1994,4,21,24,1
Jordan Adams,2015,2016,6-5,209,1994,2,21,22,1
Nik Stauskas,2015,2018,6-6,205,1993,4,22,25,1
Langston Galloway,2015,2018,6-2,200,1991,4,24,27,1
Cleanthony Early,2015,2016,6-8,210,1991,2,24,25,1
Glenn Robinson,2015,2017,6-6,222,1994,3,21,23,1
Cory Jefferson,2015,2016,6-9,218,1990,2,25,26,1
Joe Ingles,2015,2018,6-8,226,1987,4,28,31,1
Grant Jerrett,2015,2015,6-10,235,1993,1,22,22,1
Jarnell Stokes,2015,2017,6-9,263,1994,3,21,23,1
Tim Frazier,2015,2018,6-1,170,1990,4,25,28,1
Noah Vonleh,2015,2018,6-10,240,1995,4,20,23,1
David Stockton,2015,2015,5-11,165,1991,1,24,24,1
Sim Bhullar,2015,2015,7-5,360,1992,1,23,23,1
Nick Johnson,2015,2015,6-3,202,1992,1,23,23,1
Tyler Johnson,2015,2018,6-4,186,1992,4,23,26,1
Tyler Ennis,2015,2018,6-3,194,1994,4,21,24,1
Damjan Rudez,2015,2017,6-10,228,1986,3,29,31,1
James Ennis,2015,2018,6-7,210,1990,4,25,28,1
Dante Exum,2015,2017,6-6,190,1995,3,20,22,1
Joffrey Lauvergne,2015,2018,6-11,220,1991,4,24,27,1
Elijah Millsap,2015,2017,6-6,225,1987,3,28,30,1
Drew Gordon,2015,2015,6-9,245,1990,1,25,25,1
Russ Smith,2015,2016,6-0,165,1991,2,24,25,1
Elfrid Payton,2015,2018,6-4,185,1994,4,21,24,1
Jack Cooley,2015,2018,6-9,260,1991,4,24,27,1
Tarik Black,2015,2018,6-9,250,1991,4,24,27,1
Jerrelle Benimon,2015,2015,6-8,245,1991,1,24,24,1
T.J. Warren,2015,2018,6-8,230,1993,4,22,25,1
Aaron Gordon,2015,2018,6-9,220,1995,4,20,23,1
Bryce Cotton,2015,2016,6-1,165,1992,2,23,24,1
Jarell Martin,2016,2018,6-10,239,1994,3,22,24,1
Justin Anderson,2016,2018,6-6,228,1993,3,23,25,1
Josh Richardson,2016,2018,6-6,200,1993,3,23,25,1
Sasha Kaun,2016,2016,6-11,260,1985,1,31,31,1
Jordan McRae,2016,2017,6-6,185,1991,2,25,26,1
Luis Montero,2016,2016,6-7,185,1993,1,23,23,1
Anthony Brown,2016,2017,6-7,210,1992,2,24,25,1
Cristiano Felicio,2016,2018,6-10,275,1992,3,24,26,1
Coty Clarke,2016,2016,6-7,232,1992,1,24,24,1
Alan Williams,2016,2017,6-8,260,1993,2,23,24,1
Jahlil Okafor,2016,2018,6-11,275,1995,3,21,23,1
Kevon Looney,2016,2018,6-9,220,1996,3,20,22,1
Myles Turner,2016,2018,6-11,243,1996,3,20,22,1
Emmanuel Mudiay,2016,2018,6-5,200,1996,3,20,22,1
Richaun Holmes,2016,2018,6-10,245,1993,3,23,25,1
Rondae Hollis-Jefferson,2016,2018,6-7,220,1995,3,21,23,1
Josh Huestis,2016,2018,6-7,230,1991,3,25,27,1
Karl-Anthony Towns,2016,2018,7-0,244,1995,3,21,23,1
Frank Kaminsky,2016,2018,7-0,242,1993,3,23,25,1
Briante Weber,2016,2018,6-2,165,1992,3,24,26,1
Cliff Alexander,2016,2016,6-8,245,1995,1,21,21,1
Alex Stepheson,2016,2016,6-10,270,1987,1,29,29,1
Marcelo Huertas,2016,2017,6-3,200,1983,2,33,34,1
Tyus Jones,2016,2018,6-2,195,1996,3,20,22,1
Jarell Eddie,2016,2017,6-7,218,1991,2,25,26,1
Willie Reed,2016,2018,6-10,220,1990,3,26,28,1
Nikola Jokic,2016,2018,6-10,250,1995,3,21,23,1
D'Angelo Russell,2016,2018,6-5,195,1996,3,20,22,1
J.J. O'Brien,2016,2016,6-7,228,1992,1,24,24,1
Devin Booker,2016,2018,6-6,206,1996,3,20,22,1
Chris McCullough,2016,2018,6-11,200,1995,3,21,23,1
Lamar Patterson,2016,2017,6-5,225,1991,2,25,26,1
Terry Rozier,2016,2018,6-2,190,1994,3,22,24,1
Stanley Johnson,2016,2018,6-7,245,1996,3,20,22,1
Aaron Harrison,2016,2017,6-6,210,1994,2,22,23,1
T.J. McConnell,2016,2018,6-2,200,1992,3,24,26,1
Pat Connaughton,2016,2018,6-5,206,1993,3,23,25,1
Duje Dukan,2016,2016,6-9,220,1991,1,25,25,1
Norman Powell,2016,2018,6-4,215,1993,3,23,25,1
R.J. Hunter,2016,2017,6-5,185,1993,2,23,24,1
Axel Toupane,2016,2017,6-7,197,1992,2,24,25,1
Montrezl Harrell,2016,2018,6-8,240,1994,3,22,24,1
Xavier Munford,2016,2016,6-2,180,1992,1,24,24,1
Raul Neto,2016,2018,6-1,179,1992,3,24,26,1
Trey Lyles,2016,2018,6-10,234,1995,3,21,23,1
Edy Tavares,2016,2017,7-3,260,1992,2,24,25,1
Larry Nance,2016,2018,6-9,230,1993,3,23,25,1
Darrun Hilliard,2016,2018,6-6,205,1993,3,23,25,1
Rashad Vaughn,2016,2018,6-6,202,1996,3,20,22,1
Delon Wright,2016,2018,6-5,183,1992,3,24,26,1
Branden Dawson,2016,2016,6-6,225,1993,1,23,23,1
Jordan Mickey,2016,2018,6-8,235,1994,3,22,24,1
Willie Cauley-Stein,2016,2018,7-0,240,1993,3,23,25,1
Damien Inglis,2016,2016,6-8,246,1995,1,21,21,1
Jerian Grant,2016,2018,6-4,195,1992,3,24,26,1
Thanasis Antetokounmpo,2016,2016,6-7,205,1992,1,24,24,1
Tibor Pleiss,2016,2016,7-3,256,1989,1,27,27,1
Keith Appling,2016,2016,6-1,185,1992,1,24,24,1
Cameron Payne,2016,2017,6-3,185,1994,2,22,23,1
Justise Winslow,2016,2018,6-7,225,1996,3,20,22,1
Nemanja Bjelica,2016,2018,6-10,240,1988,3,28,30,1
Kristaps Porzingis,2016,2018,7-3,240,1995,3,21,23,1
Salah Mejri,2016,2018,7-1,245,1986,3,30,32,1
Bryce Dejean-Jones,2016,2016,6-6,209,1992,1,24,24,1
Sam Dekker,2016,2018,6-9,230,1994,3,22,24,1
Christian Wood,2016,2017,6-11,220,1995,2,21,22,1
Kelly Oubre,2016,2018,6-7,205,1995,3,21,23,1
Bobby Portis,2016,2018,6-11,230,1995,3,21,23,1
Jonathon Simmons,2016,2018,6-6,195,1989,3,27,29,1
Joe Young,2016,2018,6-2,180,1992,3,24,26,1
Boban Marjanovic,2016,2018,7-3,290,1988,3,28,30,1
Rakeem Christmas,2016,2017,6-9,250,1991,2,25,26,1
Mario Hezonja,2016,2018,6-8,215,1995,3,21,23,1
Quinn Cook,2017,2018,6-2,184,1993,2,24,25,1
Rodney McGruder,2017,2017,6-4,205,1991,1,26,26,1
Damian Jones,2017,2018,7-0,245,1995,2,22,23,0
Dragan Bender,2017,2018,7-1,225,1997,2,20,21,0
Stephen Zimmerman,2017,2017,7-0,240,1996,1,21,21,1
Paul Zipser,2017,2018,6-8,215,1994,2,23,24,0
Bryn Forbes,2017,2018,6-3,190,1993,2,24,25,0
Demetrius Jackson,2017,2018,6-1,201,1994,2,23,24,0
Pierre Jackson,2017,2017,5-10,180,1991,1,26,26,1
Jaylen Brown,2017,2018,6-7,225,1996,2,21,22,0
Maurice Ndour,2017,2017,6-9,200,1992,1,25,25,1
Treveon Graham,2017,2018,6-6,220,1993,2,24,25,0
Brandon Ingram,2017,2018,6-9,190,1997,2,20,21,0
Malcolm Brogdon,2017,2018,6-5,215,1992,2,25,26,0
DeAndre' Bembry,2017,2018,6-6,210,1994,2,23,24,0
Isaiah Taylor,2017,2018,6-3,170,1994,2,23,24,0
Georges Niang,2017,2017,6-8,230,1993,1,24,24,1
Shawn Long,2017,2017,6-9,255,1993,1,24,24,1
Yogi Ferrell,2017,2018,6-0,180,1993,2,24,25,0
Diamond Stone,2017,2017,6-11,255,1997,1,20,20,1
Brice Johnson,2017,2018,6-10,230,1994,2,23,24,0
Kay Felder,2017,2018,5-9,176,1995,2,22,23,0
Gary Payton,2017,2018,6-3,190,1992,2,25,26,0
Ron Baker,2017,2018,6-4,220,1993,2,24,25,0
Malachi Richardson,2017,2018,6-6,205,1996,2,21,22,0
Troy Williams,2017,2018,6-7,218,1994,2,23,24,0
Ben Bentil,2017,2017,6-9,235,1995,1,22,22,1
Kyle Wiltjer,2017,2017,6-10,240,1992,1,25,25,1
Davis Bertans,2017,2018,6-10,210,1992,2,25,26,0
Dorian Finney-Smith,2017,2018,6-8,220,1993,2,24,25,0
Wade Baldwin,2017,2017,6-4,202,1996,1,21,21,1
Alex Abrines,2017,2018,6-6,190,1993,2,24,25,0
Kris Dunn,2017,2018,6-4,210,1994,2,23,24,0
Jarrod Uthoff,2017,2017,6-9,221,1993,1,24,24,1
Chinanu Onuaku,2017,2017,6-10,245,1996,1,21,21,1
A.J. Hammons,2017,2017,7-0,260,1992,1,25,25,1
Denzel Valentine,2017,2018,6-6,212,1993,2,24,25,0
Malcolm Delaney,2017,2018,6-3,190,1989,2,28,29,0
Taurean Waller-Prince,2017,2018,6-8,220,1994,2,23,24,0
Fred VanVleet,2017,2018,6-0,195,1994,2,23,24,0
Dario Saric,2017,2018,6-10,223,1994,2,23,24,0
Ivica Zubac,2017,2018,7-1,265,1997,2,20,21,0
Jakob Poeltl,2017,2018,7-0,248,1995,2,22,23,0
Isaiah Whitehead,2017,2018,6-4,213,1995,2,22,23,0
Thon Maker,2017,2018,7-1,216,1997,2,20,21,0
Tomas Satoransky,2017,2018,6-7,210,1991,2,26,27,0
Cheick Diallo,2017,2018,6-9,220,1996,2,21,22,0
Marshall Plumlee,2017,2017,7-0,250,1992,1,25,25,1
Wayne Selden,2017,2018,6-5,230,1994,2,23,24,0
Okaro White,2017,2018,6-8,204,1992,2,25,26,0
Georgios Papagiannis,2017,2018,7-1,240,1997,2,20,21,0
Sheldon Mac,2017,2017,6-5,200,1992,1,25,25,1
Mindaugas Kuzminskas,2017,2018,6-9,215,1989,2,28,29,0
Skal Labissiere,2017,2018,6-11,225,1996,2,21,22,0
Marcus Georges-Hunt,2017,2018,6-5,216,1994,2,23,24,0
Jonathan Gibson,2017,2017,6-2,185,1987,1,30,30,1
Nicolas Laprovittola,2017,2017,6-4,180,1990,1,27,27,1
Buddy Hield,2017,2018,6-4,214,1993,2,24,25,0
Marquese Chriss,2017,2018,6-10,233,1997,2,20,21,0
Jake Layman,2017,2018,6-9,210,1994,2,23,24,0
Deyonta Davis,2017,2018,6-11,237,1996,2,21,22,0
Malik Beasley,2017,2018,6-5,196,1996,2,21,22,0
Pascal Siakam,2017,2018,6-9,230,1994,2,23,24,0
Michael Gbinije,2017,2017,6-7,200,1992,1,25,25,1
Joel Embiid,2017,2018,7-0,250,1994,2,23,24,0
Derrick Jones,2017,2018,6-7,190,1997,2,20,21,0
Joel Bolomboy,2017,2018,6-9,235,1994,2,23,24,0
Henry Ellenson,2017,2018,6-11,245,1997,2,20,21,0
David Nwaba,2017,2018,6-4,209,1993,2,24,25,0
Mike Tobey,2017,2017,7-0,260,1994,1,23,23,1
Nicolas Brussino,2017,2018,6-7,195,1993,2,24,25,0
Danuel House,2017,2018,6-7,207,1993,2,24,25,0
Jamal Murray,2017,2018,6-4,207,1997,2,20,21,0
Semaj Christon,2017,2017,6-3,190,1992,1,25,25,1
Chasson Randle,2017,2017,6-2,185,1993,1,24,24,1
Tyler Ulis,2017,2018,5-10,150,1996,2,21,22,0
Caris LeVert,2017,2018,6-7,203,1994,2,23,24,0
Dejounte Murray,2017,2018,6-5,170,1996,2,21,22,0
Patrick McCaw,2017,2018,6-7,185,1995,2,22,23,0
Domantas Sabonis,2017,2018,6-11,240,1996,2,21,22,0
Daniel Ochefu,2017,2017,6-11,245,1993,1,24,24,1
Andrew Harrison,2017,2018,6-6,213,1994,2,23,24,0
Alex Poythress,2017,2018,6-7,238,1993,2,24,25,0
Patricio Garino,2017,2017,6-6,210,1993,1,24,24,1
Timothe Luwawu-Cabarrot,2017,2018,6-6,205,1995,2,22,23,0
Tim Quarterman,2017,2017,6-6,195,1994,1,23,23,1
Juan Hernangomez,2017,2018,6-9,230,1995,2,22,23,0
Willy Hernangomez,2017,2018,6-11,240,1994,2,23,24,0
Malik Monk,2018,2018,6-3,200,1998,1,20,20,1
Jabari Bird,2018,2018,6-6,197,1994,1,24,24,1
Kobi Simmons,2018,2018,6-5,166,1997,1,21,21,1
Guerschon Yabusele,2018,2018,6-7,260,1995,1,23,23,1
Bogdan Bogdanovic,2018,2018,6-6,205,1992,1,26,26,1
Ben Simmons,2018,2018,6-10,230,1996,1,22,22,1
OG Anunoby,2018,2018,6-8,232,1997,1,21,21,1
Khem Birch,2018,2018,6-9,220,1992,1,26,26,1
Monte Morris,2018,2018,6-3,175,1995,1,23,23,1
Johnathan Motley,2018,2018,6-9,238,1995,1,23,23,1
Antonio Blakeney,2018,2018,6-4,197,1996,1,22,22,1
Ante Zizic,2018,2018,6-11,250,1997,1,21,21,1
Donovan Mitchell,2018,2018,6-3,211,1996,1,22,22,1
Josh Jackson,2018,2018,6-8,207,1997,1,21,21,1
Ryan Arcidiacono,2018,2018,6-3,188,1994,1,24,24,1
Luke Kennard,2018,2018,6-6,206,1996,1,22,22,1
Damyean Dotson,2018,2018,6-6,205,1994,1,24,24,1
Tyler Dorsey,2018,2018,6-5,183,1996,1,22,22,1
Zhou Qi,2018,2018,7-1,210,1996,1,22,22,1
Jacob Pullen,2018,2018,6-1,200,1989,1,29,29,1
Dwayne Bacon,2018,2018,6-6,222,1995,1,23,23,1
Maxi Kleber,2018,2018,6-10,220,1992,1,26,26,1
John Holland,2018,2018,6-5,205,1988,1,30,30,1
Furkan Korkmaz,2018,2018,6-7,185,1997,1,21,21,1
Kyle Kuzma,2018,2018,6-9,220,1995,1,23,23,1
Alec Peters,2018,2018,6-9,232,1995,1,23,23,1
T.J. Leaf,2018,2018,6-10,222,1997,1,21,21,1
London Perrantes,2018,2018,6-2,200,1994,1,24,24,1
Derrick Walton,2018,2018,6-1,189,1995,1,23,23,1
Torrey Craig,2018,2018,6-6,215,1990,1,28,28,1
Ivan Rabb,2018,2018,6-10,220,1997,1,21,21,1
Matt Costello,2018,2018,6-9,245,1993,1,25,25,1
Jalen Jones,2018,2018,6-7,223,1993,1,25,25,1
Jawun Evans,2018,2018,6-0,185,1996,1,22,22,1
Justin Jackson,2018,2018,6-8,200,1995,1,23,23,1
De'Aaron Fox,2018,2018,6-3,170,1997,1,21,21,1
Caleb Swanigan,2018,2018,6-8,250,1997,1,21,21,1
Lonzo Ball,2018,2018,6-6,190,1997,1,21,21,1
Mike James,2018,2018,6-1,189,1990,1,28,28,1
Wesley Iwundu,2018,2018,6-7,193,1994,1,24,24,1
Jonathan Isaac,2018,2018,6-10,210,1997,1,21,21,1
Bam Adebayo,2018,2018,6-10,243,1997,1,21,21,1
Jayson Tatum,2018,2018,6-8,205,1998,1,20,20,1
Terrance Ferguson,2018,2018,6-7,184,1998,1,20,20,1
Milos Teodosic,2018,2018,6-5,196,1987,1,31,31,1
Dakari Johnson,2018,2018,7-0,255,1995,1,23,23,1
Vince Hunter,2018,2018,6-8,208,1994,1,24,24,1
Daniel Theis,2018,2018,6-9,215,1992,1,26,26,1
Markelle Fultz,2018,2018,6-4,195,1998,1,20,20,1
Sindarius Thornwell,2018,2018,6-5,212,1994,1,24,24,1
Charles Cooke,2018,2018,6-5,196,1994,1,24,24,1
Kadeem Allen,2018,2018,6-3,192,1993,1,25,25,1
Kyle Collinsworth,2018,2018,6-6,210,1991,1,27,27,1
Semi Ojeleye,2018,2018,6-7,241,1994,1,24,24,1
C.J. Williams,2018,2018,6-5,225,1990,1,28,28,1
Royce O'Neale,2018,2018,6-6,215,1993,1,25,25,1
Thomas Bryant,2018,2018,6-10,248,1997,1,21,21,1
Frank Ntilikina,2018,2018,6-5,190,1998,1,20,20,1
Matt Williams,2018,2018,6-5,210,1993,1,25,25,1
Sterling Brown,2018,2018,6-5,225,1995,1,23,23,1
Jordan Bell,2018,2018,6-9,224,1995,1,23,23,1
Ike Anigbogu,2018,2018,6-10,252,1998,1,20,20,1
Alfonzo McKinnie,2018,2018,6-8,215,1992,1,26,26,1
Dillon Brooks,2018,2018,6-6,220,1996,1,22,22,1
D.J. Wilson,2018,2018,6-10,234,1996,1,22,22,1
Jamil Wilson,2018,2018,6-7,230,1990,1,28,28,1
Tony Bradley,2018,2018,6-11,240,1998,1,20,20,1
Malcolm Miller,2018,2018,6-7,210,1993,1,25,25,1
Mangok Mathiang,2018,2018,6-10,230,1992,1,26,26,1
Frank Mason,2018,2018,6-0,189,1994,1,24,24,1
Jacob Wiley,2018,2018,6-7,215,1994,1,24,24,1
Cedi Osman,2018,2018,6-8,210,1995,1,23,23,1
Zach Collins,2018,2018,7-0,232,1997,1,21,21,1
John Collins,2018,2018,6-10,235,1997,1,21,21,1
Jarrett Allen,2018,2018,6-10,234,1998,1,20,20,1
Brandon Paul,2018,2018,6-4,200,1991,1,27,27,1
Antonius Cleveland,2018,2018,6-6,195,1994,1,24,24,1
Gian Clavell,2018,2018,6-4,185,1993,1,25,25,1
Tyler Lydon,2018,2018,6-10,215,1996,1,22,22,1
Abdel Nader,2018,2018,6-6,230,1993,1,25,25,1
Derrick White,2018,2018,6-5,190,1994,1,24,24,1
Marcus Paige,2018,2018,6-1,175,1993,1,25,25,1
Tyler Cavanaugh,2018,2018,6-9,239,1994,1,24,24,1
Josh Hart,2018,2018,6-5,209,1995,1,23,23,1
Alex Caruso,2018,2018,6-5,186,1994,1,24,24,1
Jamel Artis,2018,2018,6-7,213,1993,1,25,25,1
Lauri Markkanen,2018,2018,7-0,230,1997,1,21,21,1
Dennis Smith,2018,2018,6-3,195,1997,1,21,21,1
Josh Magette,2018,2018,6-1,160,1989,1,29,29,1
Daniel Hamilton,2018,2018,6-7,195,1995,1,23,23,1